Date,ATM_ID,Agency,Day_of_Week,Soles_Withdrawn,Dollars_Withdrawn,Event,Holiday,Supply_Cost_Fixed,Supply_Cost_Variable,ATM_Max_Capacity_Soles,ATM_Max_Capacity_Dollars,Opportunity_Cost,Soles_Withdrawn_Lag1,Dollars_Withdrawn_Lag1,Soles_Withdrawn_Lag7,Dollars_Withdrawn_Lag7,Soles_Moving_Avg_7,Dollars_Moving_Avg_7,Total_Withdrawn,Total_Withdrawn_Lag1,Total_Withdrawn_Lag7,Total_Moving_Avg_7
1/8/2023,1,Agency_1,Sunday,20475,8563,Sports Event,0,56,29.04,91905,17296,41.83,25450,1524,40469,10437,26518.57143,7486.142857,29038,26974,50906,34004.71429
1/9/2023,1,Agency_1,Monday,29123,13394,Sports Event,1,56,42.52,91905,17296,34.12,20475,8563,34857,13678,25699.42857,7445.571429,42517,29038,48535,33145
1/10/2023,1,Agency_1,Tuesday,15459,2175,None,0,56,17.63,91905,17296,48.81,29123,13394,18829,4531,25218,7109,17634,42517,23360,32327
1/11/2023,1,Agency_1,Wednesday,53289,10824,Sports Event,1,56,64.11,91905,17296,23.84,15459,2175,41844,11107,26853,7068.571429,64113,17634,52951,33921.57143
1/12/2023,1,Agency_1,Thursday,30505,3655,Festival,0,56,34.16,91905,17296,40.25,53289,10824,17652,6085,28689.14286,6721.428571,34160,64113,23737,35410.57143
1/13/2023,1,Agency_1,Friday,33692,12425,Concert,1,56,46.12,91905,17296,32.52,30505,3655,26523,6915,29713.28571,7508.571429,46117,34160,33438,37221.85714
1/14/2023,1,Agency_1,Saturday,17094,7476,None,0,56,24.57,91905,17296,44.28,33692,12425,25450,1524,28519.57143,8358.857143,24570,46117,26974,36878.42857
1/15/2023,1,Agency_1,Sunday,30592,9759,Sports Event,0,56,40.35,91905,17296,35.93,17094,7476,20475,8563,29964.85714,8529.714286,40351,24570,29038,38494.57143
1/16/2023,1,Agency_1,Monday,33132,20715,Festival,1,56,53.85,91905,17296,26.99,30592,9759,29123,13394,30537.57143,9575.571429,53847,40351,42517,40113.14286
1/17/2023,1,Agency_1,Tuesday,29898,4902,Festival,0,56,34.8,91905,17296,39.68,33132,20715,15459,2175,32600.28571,9965.142857,34800,53847,17634,42565.42857
1/18/2023,1,Agency_1,Wednesday,36168,4348,Sports Event,0,56,40.52,91905,17296,36.93,29898,4902,53289,10824,30154.42857,9040,40516,34800,64113,39194.42857
1/19/2023,1,Agency_1,Thursday,31566,1836,Sports Event,0,56,33.4,91905,17296,40.99,36168,4348,30505,3655,30306,8780.142857,33402,40516,34160,39086.14286
1/20/2023,1,Agency_1,Friday,26050,12835,Festival,1,56,38.89,91905,17296,36.05,31566,1836,33692,12425,29214.28571,8838.714286,38885,33402,46117,38053
1/21/2023,1,Agency_1,Saturday,42645,11805,Concert,0,56,54.45,91905,17296,28.47,26050,12835,17094,7476,32864.42857,9457.142857,54450,38885,24570,42321.57143
1/22/2023,1,Agency_1,Sunday,23305,5716,None,0,56,29.02,91905,17296,42.41,42645,11805,30592,9759,31823.42857,8879.571429,29021,54450,40351,40703
1/23/2023,1,Agency_1,Monday,18910,6052,Festival,0,56,24.96,91905,17296,44.37,23305,5716,33132,20715,29791.71429,6784.857143,24962,29021,53847,36576.57143
1/24/2023,1,Agency_1,Tuesday,26544,12093,Concert,0,56,38.64,91905,17296,36.32,18910,6052,29898,4902,29312.57143,7812.142857,38637,24962,34800,37124.71429
1/25/2023,1,Agency_1,Wednesday,42350,3505,Sports Event,1,56,45.86,91905,17296,34.43,26544,12093,36168,4348,30195.71429,7691.714286,45855,38637,40516,37887.42857
1/26/2023,1,Agency_1,Thursday,42159,10065,Sports Event,1,56,52.22,91905,17296,29.93,42350,3505,31566,1836,31709,8867.285714,52224,45855,33402,40576.28571
1/27/2023,1,Agency_1,Friday,32399,14810,Concert,1,56,47.21,91905,17296,31.49,42159,10065,26050,12835,32616,9149.428571,47209,52224,38885,41765.42857
1/28/2023,1,Agency_1,Saturday,45277,15165,Festival,0,56,60.44,91905,17296,24.81,32399,14810,42645,11805,32992,9629.428571,60442,47209,54450,42621.42857
1/29/2023,1,Agency_1,Sunday,28445,9682,Festival,0,56,38.13,91905,17296,37.06,45277,15165,23305,5716,33726.28571,10196,38127,60442,29021,43922.28571
1/30/2023,1,Agency_1,Monday,32484,11816,Concert,0,56,44.3,91905,17296,33.55,28445,9682,18910,6052,35665.42857,11019.42857,44300,38127,24962,46684.85714
1/31/2023,1,Agency_1,Tuesday,34327,11014,Concert,1,56,45.34,91905,17296,33.19,32484,11816,26544,12093,36777.28571,10865.28571,45341,44300,38637,47642.57143
2/1/2023,1,Agency_1,Wednesday,28212,6204,Sports Event,1,56,34.42,91905,17296,39.61,34327,11014,42350,3505,34757.57143,11250.85714,34416,45341,45855,46008.42857
2/2/2023,1,Agency_1,Thursday,46920,18354,Concert,1,56,65.28,91905,17296,21.75,28212,6204,42159,10065,35437.71429,12435,65274,34416,52224,47872.71429
2/3/2023,1,Agency_1,Friday,19639,7007,None,0,56,26.65,91905,17296,43.34,46920,18354,32399,14810,33614.85714,11320.28571,26646,65274,47209,44935.14286
2/4/2023,1,Agency_1,Saturday,34020,6750,None,1,56,40.77,91905,17296,36.32,19639,7007,45277,15165,32006.71429,10118.14286,40770,26646,60442,42124.85714
2/5/2023,1,Agency_1,Sunday,51026,24987,Sports Event,1,56,76.01,91905,17296,15.06,34020,6750,28445,9682,35232.57143,12304.57143,76013,40770,38127,47537.14286
2/6/2023,1,Agency_1,Monday,19820,8129,None,0,56,27.95,91905,17296,42.46,51026,24987,32484,11816,33423.42857,11777.85714,27949,76013,44300,45201.28571
2/7/2023,1,Agency_1,Tuesday,10351,11293,Festival,0,56,21.64,91905,17296,44.98,19820,8129,34327,11014,29998.28571,11817.71429,21644,27949,45341,41816
2/8/2023,1,Agency_1,Wednesday,39848,10474,Sports Event,1,56,50.32,91905,17296,30.8,10351,11293,28212,6204,31660.57143,12427.71429,50322,21644,34416,44088.28571
2/9/2023,1,Agency_1,Thursday,30687,1740,Sports Event,0,56,32.43,91905,17296,41.5,39848,10474,46920,18354,29341.57143,10054.28571,32427,50322,65274,39395.85714
2/10/2023,1,Agency_1,Friday,28351,9713,Festival,0,56,38.07,91905,17296,37.08,30687,1740,19639,7007,30586.14286,10440.85714,38064,32427,26646,41027
2/11/2023,1,Agency_1,Saturday,64090,12261,Concert,1,56,76.35,91905,17296,17.43,28351,9713,34020,6750,34881.85714,11228.14286,76351,38064,40770,46110
2/12/2023,1,Agency_1,Sunday,37339,12363,Sports Event,1,56,49.7,91905,17296,30.74,64090,12261,51026,24987,32926.57143,9424.714286,49702,76351,76013,42351.28571
2/13/2023,1,Agency_1,Monday,36865,9616,Festival,0,56,46.48,91905,17296,32.9,37339,12363,19820,8129,35361.57143,9637.142857,46481,49702,27949,44998.71429
2/14/2023,1,Agency_1,Tuesday,33834,14341,Concert,1,56,48.18,91905,17296,31.1,36865,9616,10351,11293,38716.28571,10072.57143,48175,46481,21644,48788.85714
2/15/2023,1,Agency_1,Wednesday,20485,6937,None,0,56,27.42,91905,17296,42.96,33834,14341,39848,10474,35950.14286,9567.285714,27422,48175,50322,45517.42857
2/16/2023,1,Agency_1,Thursday,16489,4344,None,0,56,20.83,91905,17296,46.77,20485,6937,30687,1740,33921.85714,9939.285714,20833,27422,32427,43861.14286
2/17/2023,1,Agency_1,Friday,35176,4931,Concert,1,56,40.11,91905,17296,37.02,16489,4344,28351,9713,34896.85714,9256.142857,40107,20833,38064,44153
2/18/2023,1,Agency_1,Saturday,33508,10050,None,1,56,43.56,91905,17296,34.27,35176,4931,64090,12261,30528,8940.285714,43558,40107,76351,39468.28571
2/19/2023,1,Agency_1,Sunday,46858,14015,Sports Event,1,56,60.87,91905,17296,24.82,33508,10050,37339,12363,31887.85714,9176.285714,60873,43558,49702,41064.14286
2/20/2023,1,Agency_1,Monday,19384,7068,Festival,0,56,26.45,91905,17296,43.42,46858,14015,36865,9616,29390.57143,8812.285714,26452,60873,46481,38202.85714
2/21/2023,1,Agency_1,Tuesday,23771,4753,None,1,56,28.52,91905,17296,42.85,19384,7068,33834,14341,27953,7442.571429,28524,26452,48175,35395.57143
2/22/2023,1,Agency_1,Wednesday,28789,9873,Festival,0,56,38.66,91905,17296,36.75,23771,4753,20485,6937,29139.28571,7862,38662,28524,27422,37001.28571
2/23/2023,1,Agency_1,Thursday,57388,12730,Festival,1,56,70.12,91905,17296,20.45,28789,9873,16489,4344,34982,9060,70118,38662,20833,44042
2/24/2023,1,Agency_1,Friday,41509,11545,Concert,1,56,53.06,91905,17296,29.22,57388,12730,35176,4931,35886.71429,10004.85714,53054,70118,40107,45891.57143
2/25/2023,1,Agency_1,Saturday,16233,9001,None,1,56,25.24,91905,17296,43.64,41509,11545,33508,10050,33418.85714,9855,25234,53054,43558,43273.85714
2/26/2023,1,Agency_1,Sunday,36541,21936,Concert,0,56,58.48,91905,17296,24.43,16233,9001,46858,14015,31945,10986.57143,58477,25234,60873,42931.57143
2/27/2023,1,Agency_1,Monday,28557,9525,Festival,0,56,38.08,91905,17296,37.11,36541,21936,19384,7068,33255.42857,11337.57143,38082,58477,26452,44593
2/28/2023,1,Agency_1,Tuesday,38660,6335,Concert,1,56,45,91905,17296,34.29,28557,9525,23771,4753,35382.42857,11563.57143,44995,38082,28524,46946
3/1/2023,1,Agency_1,Wednesday,38571,11055,Concert,0,56,49.63,91905,17296,31.04,38660,6335,28789,9873,36779.85714,11732.42857,49626,44995,38662,48512.28571
3/2/2023,1,Agency_1,Thursday,46712,7570,Festival,1,56,54.28,91905,17296,29.4,38571,11055,57388,12730,35254.71429,10995.28571,54282,49626,70118,46250
3/3/2023,1,Agency_1,Friday,27013,2196,None,0,56,29.21,91905,17296,43.02,46712,7570,41509,11545,33183.85714,9659.714286,29209,54282,53054,42843.57143
3/4/2023,1,Agency_1,Saturday,53665,29021,Festival,1,56,82.69,91905,17296,10.91,27013,2196,16233,9001,38531.28571,12519.71429,82686,29209,25234,51051
3/5/2023,1,Agency_1,Sunday,27084,8546,Concert,0,56,35.63,91905,17296,38.54,53665,29021,36541,21936,37180.28571,10606.85714,35630,82686,58477,47787.14286
3/6/2023,1,Agency_1,Monday,30747,6788,Concert,0,56,37.54,91905,17296,37.93,27084,8546,28557,9525,37493.14286,10215.85714,37535,35630,38082,47709
3/7/2023,1,Agency_1,Tuesday,15919,7191,None,1,56,23.11,91905,17296,45.07,30747,6788,38660,6335,34244.42857,10338.14286,23110,37535,44995,44582.57143
3/8/2023,1,Agency_1,Wednesday,14688,5947,None,0,56,20.64,91905,17296,46.55,15919,7191,38571,11055,30832.57143,9608.428571,20635,23110,49626,40441
3/9/2023,1,Agency_1,Thursday,30033,19275,Concert,1,56,49.31,91905,17296,29.55,14688,5947,46712,7570,28449.85714,11280.57143,49308,20635,54282,39730.42857
3/10/2023,1,Agency_1,Friday,31361,10364,Concert,1,56,41.73,91905,17296,35.12,30033,19275,27013,2196,29071,12447.42857,41725,49308,29209,41518.42857
3/11/2023,1,Agency_1,Saturday,43320,5608,Sports Event,0,56,48.93,91905,17296,32.47,31361,10364,53665,29021,27593.14286,9102.714286,48928,41725,82686,36695.85714
3/12/2023,1,Agency_1,Sunday,49460,23557,Concert,1,56,73.02,91905,17296,16.84,43320,5608,27084,8546,30789.71429,11247.14286,73017,48928,35630,42036.85714
3/13/2023,1,Agency_1,Monday,23325,12778,Sports Event,1,56,36.1,91905,17296,37.45,49460,23557,30747,6788,29729.42857,12102.85714,36103,73017,37535,41832.28571
3/14/2023,1,Agency_1,Tuesday,41533,15619,Sports Event,1,56,57.15,91905,17296,26.36,23325,12778,15919,7191,33388.57143,13306.85714,57152,36103,23110,46695.42857
3/15/2023,1,Agency_1,Wednesday,13815,2359,None,0,56,16.17,91905,17296,49.5,41533,15619,14688,5947,33263.85714,12794.28571,16174,57152,20635,46058.14286
3/16/2023,1,Agency_1,Thursday,33913,9508,Concert,0,56,43.42,91905,17296,34.45,13815,2359,30033,19275,33818.14286,11399,43421,16174,49308,45217.14286
3/17/2023,1,Agency_1,Friday,31878,9676,Festival,0,56,41.55,91905,17296,35.35,33913,9508,31361,10364,33892,11300.71429,41554,43421,41725,45192.71429
3/18/2023,1,Agency_1,Saturday,29878,12075,Concert,0,56,41.95,91905,17296,34.67,31878,9676,43320,5608,31971.71429,12224.57143,41953,41554,48928,44196.28571
3/19/2023,1,Agency_1,Sunday,25758,4642,None,0,56,30.4,91905,17296,41.93,29878,12075,49460,23557,28585.71429,9522.428571,30400,41953,73017,38108.14286
3/20/2023,1,Agency_1,Monday,29328,5947,None,0,56,35.27,91905,17296,39.23,25758,4642,23325,12778,29443.28571,8546.571429,35275,30400,36103,37989.85714
3/21/2023,1,Agency_1,Tuesday,14043,6313,None,0,56,20.36,91905,17296,46.62,29328,5947,41533,15619,25516.14286,7217.142857,20356,35275,57152,32733.28571
3/22/2023,1,Agency_1,Wednesday,22689,11175,Festival,0,56,33.86,91905,17296,38.89,14043,6313,13815,2359,26783.85714,8476.571429,33864,20356,16174,35260.42857
3/23/2023,1,Agency_1,Thursday,50294,7992,Concert,1,56,58.29,91905,17296,27.32,22689,11175,33913,9508,29124,8260,58286,33864,43421,37384
3/24/2023,1,Agency_1,Friday,37224,9902,Sports Event,0,56,47.13,91905,17296,32.52,50294,7992,31878,9676,29887.71429,8292.285714,47126,58286,41554,38180
3/25/2023,1,Agency_1,Saturday,56417,27205,Concert,1,56,83.62,91905,17296,10.81,37224,9902,29878,12075,33679,10453.71429,83622,47126,41953,44132.71429
3/26/2023,1,Agency_1,Sunday,43928,10804,Concert,1,56,54.73,91905,17296,28.53,56417,27205,25758,4642,36274.71429,11334,54732,83622,30400,47608.71429
3/27/2023,1,Agency_1,Monday,23328,5725,Sports Event,0,56,29.05,91905,17296,42.39,43928,10804,29328,5947,35417.57143,11302.28571,29053,54732,35275,46719.85714
3/28/2023,1,Agency_1,Tuesday,19614,5682,None,0,56,25.3,91905,17296,44.28,23328,5725,14043,6313,36213.42857,11212.14286,25296,29053,20356,47425.57143
3/29/2023,1,Agency_1,Wednesday,41696,15836,Sports Event,1,56,57.53,91905,17296,26.13,19614,5682,22689,11175,38928.71429,11878,57532,25296,33864,50806.71429
3/30/2023,1,Agency_1,Thursday,39126,18818,Sports Event,1,56,57.95,91905,17296,25.32,41696,15836,50294,7992,37333.28571,13424.57143,57944,57532,58286,50757.85714
3/31/2023,1,Agency_1,Friday,28014,17748,Sports Event,0,56,45.76,91905,17296,31.63,39126,18818,37224,9902,36017.57143,14545.42857,45762,57944,47126,50563
4/1/2023,1,Agency_1,Saturday,27753,4270,None,0,56,32.02,91905,17296,41.19,28014,17748,56417,27205,31922.71429,11269,32023,45762,83622,43191.71429
4/2/2023,1,Agency_1,Sunday,34269,18452,Sports Event,1,56,52.72,91905,17296,28.01,27753,4270,43928,10804,30542.85714,12361.57143,52721,32023,54732,42904.42857
4/3/2023,1,Agency_1,Monday,18882,6428,None,0,56,25.31,91905,17296,44.12,34269,18452,23328,5725,29907.71429,12462,25310,52721,29053,42369.71429
4/4/2023,1,Agency_1,Tuesday,33549,8251,Concert,0,56,41.8,91905,17296,35.51,18882,6428,19614,5682,31898.42857,12829,41800,25310,25296,44727.42857
4/5/2023,1,Agency_1,Wednesday,23649,3349,Sports Event,0,56,27,91905,17296,43.89,33549,8251,41696,15836,29320.28571,11045.14286,26998,41800,57532,40365.42857
4/6/2023,1,Agency_1,Thursday,26650,11410,Sports Event,0,56,38.06,91905,17296,36.75,23649,3349,39126,18818,27538,9986.857143,38060,26998,57944,37524.85714
4/7/2023,1,Agency_1,Friday,41086,5969,Festival,1,56,47.06,91905,17296,33.34,26650,11410,28014,17748,29405.42857,8304.142857,47055,38060,45762,37709.57143
4/8/2023,1,Agency_1,Saturday,37557,12751,Concert,0,56,50.31,91905,17296,30.36,41086,5969,27753,4270,30806,9515.714286,50308,47055,32023,40321.71429
4/9/2023,1,Agency_1,Sunday,28044,11728,Sports Event,0,56,39.77,91905,17296,35.83,37557,12751,34269,18452,29916.71429,8555.142857,39772,50308,52721,38471.85714
4/10/2023,1,Agency_1,Monday,20291,2714,None,0,56,23,91905,17296,46.01,28044,11728,18882,6428,30118,8024.571429,23005,39772,25310,38142.57143
4/11/2023,1,Agency_1,Tuesday,21788,6121,None,0,56,27.91,91905,17296,42.88,20291,2714,33549,8251,28437.85714,7720.285714,27909,23005,41800,36158.14286
4/12/2023,1,Agency_1,Wednesday,49559,16914,Concert,1,56,66.47,91905,17296,21.44,21788,6121,23649,3349,32139.28571,9658.142857,66473,27909,26998,41797.42857
4/13/2023,1,Agency_1,Thursday,25566,7435,Sports Event,1,56,33,91905,17296,40.07,49559,16914,26650,11410,31984.42857,9090.285714,33001,66473,38060,41074.71429
4/14/2023,1,Agency_1,Friday,44021,14344,Concert,1,56,58.37,91905,17296,26.01,25566,7435,41086,5969,32403.71429,10286.71429,58365,33001,47055,42690.42857
4/15/2023,1,Agency_1,Saturday,27090,16516,None,0,56,43.61,91905,17296,32.95,44021,14344,37557,12751,30908.42857,10824.57143,43606,58365,50308,41733
4/16/2023,1,Agency_1,Sunday,41137,16068,Sports Event,0,56,57.21,91905,17296,26.24,27090,16516,28044,11728,32778.85714,11444.57143,57205,43606,39772,44223.42857
4/17/2023,1,Agency_1,Monday,48301,14998,Sports Event,1,56,63.3,91905,17296,23.41,41137,16068,20291,2714,36780.28571,13199.42857,63299,57205,23005,49979.71429
4/18/2023,1,Agency_1,Tuesday,35924,15510,Sports Event,1,56,51.44,91905,17296,29.24,48301,14998,21788,6121,38799.71429,14540.71429,51434,63299,27909,53340.42857
4/19/2023,1,Agency_1,Wednesday,31463,10771,Sports Event,1,56,42.24,91905,17296,34.79,35924,15510,49559,16914,36214.57143,13663.14286,42234,51434,66473,49877.71429
4/20/2023,1,Agency_1,Thursday,26359,8777,Concert,0,56,35.14,91905,17296,38.74,31463,10771,25566,7435,36327.85714,13854.85714,35136,42234,33001,50182.71429
4/21/2023,1,Agency_1,Friday,47359,2150,Festival,0,56,49.51,91905,17296,32.87,26359,8777,44021,14344,36804.71429,12112.85714,49509,35136,58365,48917.57143
4/22/2023,1,Agency_1,Saturday,28117,2306,None,0,56,30.42,91905,17296,42.39,47359,2150,27090,16516,36951.42857,10082.85714,30423,49509,43606,47034.28571
4/23/2023,1,Agency_1,Sunday,31752,15861,Festival,0,56,47.61,91905,17296,31.08,28117,2306,41137,16068,35610.71429,10053.28571,47613,30423,57205,45664
4/24/2023,1,Agency_1,Monday,26417,3981,None,1,56,30.4,91905,17296,42.06,31752,15861,48301,14998,32484.42857,8479.428571,30398,47613,63299,40963.85714
4/25/2023,1,Agency_1,Tuesday,24634,10810,Concert,0,56,35.44,91905,17296,38.18,26417,3981,35924,15510,30871.57143,7808,35444,30398,51434,38679.57143
4/26/2023,1,Agency_1,Wednesday,16348,5432,None,0,56,21.78,91905,17296,46.08,24634,10810,31463,10771,28712.28571,7045.285714,21780,35444,42234,35757.57143
4/27/2023,1,Agency_1,Thursday,20227,3696,None,0,56,23.92,91905,17296,45.36,16348,5432,26359,8777,27836.28571,6319.428571,23923,21780,35136,34155.71429
4/28/2023,1,Agency_1,Friday,59902,14915,Concert,1,56,74.82,91905,17296,17.67,20227,3696,47359,2150,29628.14286,8143,74817,23923,49509,37771.14286
4/29/2023,1,Agency_1,Saturday,11848,6983,None,0,56,18.83,91905,17296,47.25,59902,14915,28117,2306,27304,8811.142857,18831,74817,30423,36115.14286
4/30/2023,1,Agency_1,Sunday,20029,8715,None,0,56,28.74,91905,17296,41.94,11848,6983,31752,15861,25629.28571,7790.285714,28744,18831,47613,33419.57143
5/1/2023,1,Agency_1,Monday,31272,11352,Sports Event,1,56,42.62,91905,17296,34.48,20029,8715,26417,3981,26322.85714,8843.285714,42624,28744,30398,35166.14286
5/2/2023,1,Agency_1,Tuesday,33786,11442,Festival,0,56,45.23,91905,17296,33.16,31272,11352,24634,10810,27630.28571,8933.571429,45228,42624,35444,36563.85714
5/3/2023,1,Agency_1,Wednesday,20997,7361,Festival,0,56,28.36,91905,17296,42.41,33786,11442,16348,5432,28294.42857,9209.142857,28358,45228,21780,37503.57143
5/4/2023,1,Agency_1,Thursday,34368,8789,Festival,1,56,43.16,91905,17296,34.72,20997,7361,20227,3696,30314.57143,9936.714286,43157,28358,23923,40251.28571
5/5/2023,1,Agency_1,Friday,56212,13825,Concert,1,56,70.04,91905,17296,20.28,34368,8789,59902,14915,29787.42857,9781,70037,43157,74817,39568.42857
5/6/2023,1,Agency_1,Saturday,32046,21147,Sports Event,1,56,53.19,91905,17296,27.23,56212,13825,11848,6983,32672.85714,11804.42857,53193,70037,18831,44477.28571
5/7/2023,1,Agency_1,Sunday,36732,9183,None,0,56,45.92,91905,17296,33.27,32046,21147,20029,8715,35059,11871.28571,45915,53193,28744,46930.28571
5/8/2023,1,Agency_1,Monday,18604,6852,Sports Event,0,56,25.46,91905,17296,43.96,36732,9183,31272,11352,33249.28571,11228.42857,25456,45915,42624,44477.71429
5/9/2023,1,Agency_1,Tuesday,26334,3584,None,0,56,29.92,91905,17296,42.38,18604,6852,33786,11442,32184.71429,10105.85714,29918,25456,45228,42290.57143
5/10/2023,1,Agency_1,Wednesday,33328,11133,Festival,0,56,44.46,91905,17296,33.6,26334,3584,20997,7361,33946.28571,10644.71429,44461,29918,28358,44591
5/11/2023,1,Agency_1,Thursday,23047,8296,Festival,0,56,31.34,91905,17296,40.73,33328,11133,34368,8789,32329,10574.28571,31343,44461,43157,42903.28571
5/12/2023,1,Agency_1,Friday,7396,7023,Concert,1,56,14.42,91905,17296,49.45,23047,8296,56212,13825,25355.28571,9602.571429,14419,31343,70037,34957.85714
5/13/2023,1,Agency_1,Saturday,33726,5533,Festival,0,56,39.26,91905,17296,37.32,7396,7023,32046,21147,25595.28571,7372,39259,14419,53193,32967.28571
5/14/2023,1,Agency_1,Sunday,65899,6618,Sports Event,1,56,72.52,91905,17296,20.48,33726,5533,36732,9183,29762,7005.571429,72517,39259,45915,36767.57143
5/15/2023,1,Agency_1,Monday,23138,7365,None,1,56,30.5,91905,17296,41.33,65899,6618,18604,6852,30409.71429,7078.857143,30503,72517,25456,37488.57143
5/16/2023,1,Agency_1,Tuesday,27206,2128,None,0,56,29.33,91905,17296,42.97,23138,7365,26334,3584,30534.28571,6870.857143,29334,30503,29918,37405.14286
5/17/2023,1,Agency_1,Wednesday,38722,8534,Festival,0,56,47.26,91905,17296,32.72,27206,2128,33328,11133,31304.85714,6499.571429,47256,29334,44461,37804.42857
5/18/2023,1,Agency_1,Thursday,15092,5924,None,0,56,21.02,91905,17296,46.37,38722,8534,23047,8296,30168.42857,6160.714286,21016,47256,31343,36329.14286
5/19/2023,1,Agency_1,Friday,40940,9041,Festival,1,56,49.98,91905,17296,31.26,15092,5924,7396,7023,34960.42857,6449,49981,21016,14419,41409.42857
5/20/2023,1,Agency_1,Saturday,47616,13084,Concert,1,56,60.7,91905,17296,25.09,40940,9041,33726,5533,36944.71429,7527.714286,60700,49981,39259,44472.42857
5/21/2023,1,Agency_1,Sunday,48126,19566,Concert,1,56,67.69,91905,17296,20.3,47616,13084,65899,6618,34405.71429,9377.428571,67692,60700,72517,43783.14286
5/22/2023,1,Agency_1,Monday,54463,6007,Sports Event,1,56,60.47,91905,17296,26.62,48126,19566,23138,7365,38880.71429,9183.428571,60470,67692,30503,48064.14286
5/23/2023,1,Agency_1,Tuesday,30665,1095,None,0,56,31.76,91905,17296,41.96,54463,6007,27206,2128,39374.85714,9035.857143,31760,60470,29334,48410.71429
5/24/2023,1,Agency_1,Wednesday,37519,14698,Sports Event,1,56,52.22,91905,17296,29.01,30665,1095,38722,8534,39203,9916.428571,52217,31760,47256,49119.42857
5/25/2023,1,Agency_1,Thursday,21404,3754,None,0,56,25.16,91905,17296,44.73,37519,14698,15092,5924,40104.71429,9606.428571,25158,52217,21016,49711.14286
5/26/2023,1,Agency_1,Friday,28438,6822,Festival,0,56,35.26,91905,17296,39.06,21404,3754,40940,9041,38318.71429,9289.428571,35260,25158,49981,47608.14286
5/27/2023,1,Agency_1,Saturday,30695,14804,Festival,0,56,45.5,91905,17296,32.35,28438,6822,47616,13084,35901.42857,9535.142857,45499,35260,60700,45436.57143
5/28/2023,1,Agency_1,Sunday,50976,11181,Sports Event,1,56,62.16,91905,17296,24.74,30695,14804,48126,19566,36308.57143,8337.285714,62157,45499,67692,44645.85714
5/29/2023,1,Agency_1,Monday,24497,5614,None,0,56,30.11,91905,17296,41.88,50976,11181,54463,6007,32027.71429,8281.142857,30111,62157,60470,40308.85714
5/30/2023,1,Agency_1,Tuesday,24064,6259,None,0,56,30.32,91905,17296,41.65,24497,5614,30665,1095,31084.71429,9018.857143,30323,30111,31760,40103.57143
5/31/2023,1,Agency_1,Wednesday,20611,5430,None,1,56,26.04,91905,17296,43.95,24064,6259,37519,14698,28669.28571,7694.857143,26041,30323,52217,36364.14286
6/1/2023,1,Agency_1,Thursday,46285,14803,Concert,1,56,61.09,91905,17296,24.55,20611,5430,21404,3754,32223.71429,9273.285714,61088,26041,25158,41497
6/2/2023,1,Agency_1,Friday,29842,8897,Concert,0,56,38.74,91905,17296,36.91,46285,14803,28438,6822,32424.28571,9569.714286,38739,61088,35260,41994
6/3/2023,1,Agency_1,Saturday,61747,11806,Festival,1,56,73.55,91905,17296,18.92,29842,8897,30695,14804,36860.28571,9141.428571,73553,38739,45499,46001.71429
6/4/2023,1,Agency_1,Sunday,35466,8362,None,1,56,43.83,91905,17296,34.47,61747,11806,50976,11181,34644.57143,8738.714286,43828,73553,62157,43383.28571
6/5/2023,1,Agency_1,Monday,28366,12234,Concert,0,56,40.6,91905,17296,35.31,35466,8362,24497,5614,35197.28571,9684.428571,40600,43828,30111,44881.71429
6/6/2023,1,Agency_1,Tuesday,31365,9277,None,1,56,40.64,91905,17296,35.88,28366,12234,24064,6259,36240.28571,10115.57143,40642,40600,30323,46355.85714
6/7/2023,1,Agency_1,Wednesday,39790,8571,Sports Event,0,56,48.36,91905,17296,32.16,31365,9277,20611,5430,38980.14286,10564.28571,48361,40642,26041,49544.42857
6/8/2023,1,Agency_1,Thursday,35113,7444,Concert,0,56,42.56,91905,17296,35.29,39790,8571,46285,14803,37384.14286,9513,42557,48361,61088,46897.14286
6/9/2023,1,Agency_1,Friday,42159,11278,Concert,1,56,53.44,91905,17296,29.09,35113,7444,29842,8897,39143.71429,9853.142857,53437,42557,38739,48996.85714
6/10/2023,1,Agency_1,Saturday,24580,8047,None,0,56,32.63,91905,17296,40.14,42159,11278,61747,11806,33834.14286,9316.142857,32627,53437,73553,43150.28571
6/11/2023,1,Agency_1,Sunday,37224,28415,Festival,1,56,65.64,91905,17296,19.56,24580,8047,35466,8362,34085.28571,12180.85714,65639,32627,43828,46266.14286
6/12/2023,1,Agency_1,Monday,29189,6118,Concert,1,56,35.31,91905,17296,39.18,37224,28415,28366,12234,34202.85714,11307.14286,35307,65639,40600,45510
6/13/2023,1,Agency_1,Tuesday,38685,11191,Concert,0,56,49.88,91905,17296,30.88,29189,6118,31365,9277,35248.57143,11580.57143,49876,35307,40642,46829.14286
6/14/2023,1,Agency_1,Wednesday,34680,10635,Sports Event,0,56,45.32,91905,17296,33.28,38685,11191,39790,8571,34518.57143,11875.42857,45315,49876,48361,46394
6/15/2023,1,Agency_1,Thursday,29907,5448,Sports Event,0,56,35.36,91905,17296,39.29,34680,10635,35113,7444,33774.85714,11590.28571,35355,45315,42557,45365.14286
6/16/2023,1,Agency_1,Friday,39739,8675,Concert,1,56,48.41,91905,17296,32.12,29907,5448,42159,11278,33429.14286,11218.42857,48414,35355,53437,44647.57143
6/17/2023,1,Agency_1,Saturday,58207,14557,Festival,1,56,72.76,91905,17296,18.77,39739,8675,24580,8047,38233,12148.42857,72764,48414,32627,50381.42857
6/18/2023,1,Agency_1,Sunday,28569,9628,Concert,0,56,38.2,91905,17296,37.03,58207,14557,37224,28415,36996.57143,9464.571429,38197,72764,65639,46461.14286
6/19/2023,1,Agency_1,Monday,22064,3872,None,0,56,25.94,91905,17296,44.32,28569,9628,29189,6118,35978.71429,9143.714286,25936,38197,35307,45122.42857
6/20/2023,1,Agency_1,Tuesday,30981,13059,Sports Event,1,56,44.04,91905,17296,33.43,22064,3872,38685,11191,34878.14286,9410.571429,44040,25936,49876,44288.71429
6/21/2023,1,Agency_1,Wednesday,31836,6776,Festival,0,56,38.61,91905,17296,37.4,30981,13059,34680,10635,34471.85714,8859.285714,38612,44040,45315,43331.14286
6/22/2023,1,Agency_1,Thursday,34405,13004,Festival,1,56,47.41,91905,17296,31.75,31836,6776,29907,5448,35114.42857,9938.714286,47409,38612,35355,45053.14286
6/23/2023,1,Agency_1,Friday,24880,5200,Sports Event,1,56,30.08,91905,17296,41.98,34405,13004,39739,8675,32991.71429,9442.285714,30080,47409,48414,42434
6/24/2023,1,Agency_1,Saturday,19688,5944,None,0,56,25.63,91905,17296,44.05,24880,5200,58207,14557,27489,8211.857143,25632,30080,72764,35700.85714
6/25/2023,1,Agency_1,Sunday,38797,17569,Festival,0,56,56.37,91905,17296,26.36,19688,5944,28569,9628,28950.14286,9346.285714,56366,25632,38197,38296.42857
6/26/2023,1,Agency_1,Monday,36432,7956,Festival,0,56,44.39,91905,17296,34.27,38797,17569,22064,3872,31002.71429,9929.714286,44388,56366,25936,40932.42857
6/27/2023,1,Agency_1,Tuesday,25875,4191,None,1,56,30.07,91905,17296,42.19,36432,7956,30981,13059,30273.28571,8662.857143,30066,44388,44040,38936.14286
6/28/2023,1,Agency_1,Wednesday,38818,10524,Festival,1,56,49.34,91905,17296,31.28,25875,4191,31836,6776,31270.71429,9198.285714,49342,30066,38612,40469
6/29/2023,1,Agency_1,Thursday,32419,5686,Sports Event,0,56,38.11,91905,17296,37.87,38818,10524,34405,13004,30987,8152.857143,38105,49342,47409,39139.85714
6/30/2023,1,Agency_1,Friday,33894,13710,Sports Event,0,56,47.6,91905,17296,31.52,32419,5686,24880,5200,32274.71429,9368.571429,47604,38105,30080,41643.28571
7/1/2023,1,Agency_1,Saturday,35020,12824,Festival,0,56,47.85,91905,17296,31.57,33894,13710,19688,5944,34465,10351.42857,47844,47604,25632,44816.42857
7/2/2023,1,Agency_1,Sunday,42210,9275,Sports Event,0,56,51.49,91905,17296,30.46,35020,12824,38797,17569,34952.57143,9166.571429,51485,47844,56366,44119.14286
7/3/2023,1,Agency_1,Monday,41184,11959,Concert,1,56,53.14,91905,17296,29.1,42210,9275,36432,7956,35631.42857,9738.428571,53143,51485,44388,45369.85714
7/4/2023,1,Agency_1,Tuesday,30732,5870,Sports Event,0,56,36.6,91905,17296,38.58,41184,11959,25875,4191,36325.28571,9978.285714,36602,53143,30066,46303.57143
7/5/2023,1,Agency_1,Wednesday,39237,14268,Festival,1,56,53.51,91905,17296,28.45,30732,5870,38818,10524,36385.14286,10513.14286,53505,36602,49342,46898.28571
7/6/2023,1,Agency_1,Thursday,35431,9685,None,1,56,45.12,91905,17296,33.56,39237,14268,32419,5686,36815.42857,11084.42857,45116,53505,38105,47899.85714
7/7/2023,1,Agency_1,Friday,59991,8246,Festival,1,56,68.24,91905,17296,22.29,35431,9685,33894,13710,40543.57143,10303.85714,68237,45116,47604,50847.42857
7/8/2023,1,Agency_1,Saturday,57004,16602,Festival,1,56,73.61,91905,17296,17.94,59991,8246,35020,12824,43684.14286,10843.57143,73606,68237,47844,54527.71429
7/9/2023,1,Agency_1,Sunday,55708,7476,Festival,0,56,63.18,91905,17296,24.97,57004,16602,42210,9275,45612.42857,10586.57143,63184,73606,51485,56199
7/10/2023,1,Agency_1,Monday,30811,9046,Concert,1,56,39.86,91905,17296,36.32,55708,7476,41184,11959,44130.57143,10170.42857,39857,63184,53143,54301
7/11/2023,1,Agency_1,Tuesday,14070,6711,Sports Event,0,56,20.78,91905,17296,46.33,30811,9046,30732,5870,41750.28571,10290.57143,20781,39857,36602,52040.85714
7/12/2023,1,Agency_1,Wednesday,31597,12614,Festival,1,56,44.21,91905,17296,33.43,14070,6711,39237,14268,40658.85714,10054.28571,44211,20781,53505,50713.14286
7/13/2023,1,Agency_1,Thursday,28220,12252,None,1,56,40.47,91905,17296,35.37,31597,12614,35431,9685,39628.71429,10421,40472,44211,45116,50049.71429
7/14/2023,1,Agency_1,Friday,37128,6538,Festival,0,56,43.67,91905,17296,34.92,28220,12252,59991,8246,36362.57143,10177,43666,40472,68237,46539.57143
7/15/2023,1,Agency_1,Saturday,36286,18511,Sports Event,1,56,54.8,91905,17296,26.96,37128,6538,57004,16602,33402.85714,10449.71429,54797,43666,73606,43852.57143
7/16/2023,1,Agency_1,Sunday,31351,26800,Sports Event,1,56,58.15,91905,17296,23.62,36286,18511,55708,7476,29923.28571,13210.28571,58151,54797,63184,43133.57143
7/17/2023,1,Agency_1,Monday,38845,6903,Sports Event,0,56,45.75,91905,17296,33.8,31351,26800,30811,9046,31071,12904.14286,45748,58151,39857,43975.14286
7/18/2023,1,Agency_1,Tuesday,17151,13101,Sports Event,0,56,30.25,91905,17296,40.31,38845,6903,14070,6711,31511.14286,13817,30252,45748,20781,45328.14286
7/19/2023,1,Agency_1,Wednesday,25255,10465,None,1,56,35.72,91905,17296,38.11,17151,13101,31597,12614,30605.14286,13510,35720,30252,44211,44115.14286
7/20/2023,1,Agency_1,Thursday,18040,6461,Festival,0,56,24.5,91905,17296,44.52,25255,10465,28220,12252,29150.85714,12682.71429,24501,35720,40472,41833.57143
7/21/2023,1,Agency_1,Friday,39050,12121,Concert,1,56,51.17,91905,17296,30.05,18040,6461,37128,6538,29425.42857,13480.28571,51171,24501,43666,42905.71429
7/22/2023,1,Agency_1,Saturday,31948,13801,Concert,0,56,45.75,91905,17296,32.42,39050,12121,36286,18511,28805.71429,12807.42857,45749,51171,54797,41613.14286
7/23/2023,1,Agency_1,Sunday,26389,10420,Concert,0,56,36.81,91905,17296,37.57,31948,13801,31351,26800,28096.85714,10467.42857,36809,45749,58151,38564.28571
7/24/2023,1,Agency_1,Monday,20601,6028,None,0,56,26.63,91905,17296,43.54,26389,10420,38845,6903,25490.57143,10342.42857,26629,36809,45748,35833
7/25/2023,1,Agency_1,Tuesday,35337,4675,Sports Event,0,56,40.01,91905,17296,37.12,20601,6028,17151,13101,28088.57143,9138.714286,40012,26629,30252,37227.28571
7/26/2023,1,Agency_1,Wednesday,24041,17980,Sports Event,1,56,42.02,91905,17296,33.45,35337,4675,25255,10465,27915.14286,10212.28571,42021,40012,35720,38127.42857
7/27/2023,1,Agency_1,Thursday,42238,8337,Concert,1,56,50.58,91905,17296,31.1,24041,17980,18040,6461,31372,10480.28571,50575,42021,24501,41852.28571
7/28/2023,1,Agency_1,Friday,54122,12449,Sports Event,1,56,66.57,91905,17296,22.28,42238,8337,39050,12121,33525.14286,10527.14286,66571,50575,51171,44052.28571
7/29/2023,1,Agency_1,Saturday,46612,11348,Concert,0,56,57.96,91905,17296,26.81,54122,12449,31948,13801,35620,10176.71429,57960,66571,45749,45796.71429
7/30/2023,1,Agency_1,Sunday,36363,11063,None,0,56,47.43,91905,17296,32.13,46612,11348,26389,10420,37044.85714,10268.57143,47426,57960,36809,47313.42857
7/31/2023,1,Agency_1,Monday,28132,11803,Sports Event,0,56,39.94,91905,17296,35.73,36363,11063,20601,6028,38120.71429,11093.57143,39935,47426,26629,49214.28571
8/1/2023,1,Agency_1,Tuesday,45290,18414,Concert,1,56,63.7,91905,17296,22.52,28132,11803,35337,4675,39542.57143,13056.28571,63704,39935,40012,52598.85714
8/2/2023,1,Agency_1,Wednesday,15175,6372,None,0,56,21.55,91905,17296,46.01,45290,18414,24041,17980,38276,11398,21547,63704,42021,49674
8/3/2023,1,Agency_1,Thursday,32879,2074,None,1,56,34.95,91905,17296,40.17,15175,6372,42238,8337,36939,10503.28571,34953,21547,50575,47442.28571
8/4/2023,1,Agency_1,Friday,27461,2191,Concert,1,56,29.65,91905,17296,42.79,32879,2074,54122,12449,33130.28571,9037.857143,29652,34953,66571,42168.14286
8/5/2023,1,Agency_1,Saturday,43645,19909,Festival,1,56,63.56,91905,17296,22.3,27461,2191,46612,11348,32706.42857,10260.85714,63554,29652,57960,42967.28571
8/6/2023,1,Agency_1,Sunday,64375,15927,Sports Event,1,56,80.3,91905,17296,14.72,43645,19909,36363,11063,36708.14286,10955.71429,80302,63554,47426,47663.85714
8/7/2023,1,Agency_1,Monday,54878,5328,Concert,1,56,60.21,91905,17296,26.89,64375,15927,28132,11803,40529,10030.71429,60206,80302,39935,50559.71429
8/8/2023,1,Agency_1,Tuesday,22391,11633,Sports Event,1,56,34.03,91905,17296,38.72,54878,5328,45290,18414,37257.71429,9062,34024,60206,63704,46319.71429
8/9/2023,1,Agency_1,Wednesday,42744,11742,Concert,1,56,54.49,91905,17296,28.47,22391,11633,15175,6372,41196.14286,9829.142857,54486,34024,21547,51025.28571
8/10/2023,1,Agency_1,Thursday,14493,8195,Sports Event,0,56,22.69,91905,17296,45.08,42744,11742,32879,2074,38569.57143,10703.57143,22688,54486,34953,49273.14286
8/11/2023,1,Agency_1,Friday,26280,15086,Festival,1,56,41.37,91905,17296,34.36,14493,8195,27461,2191,38400.85714,12545.71429,41366,22688,29652,50946.57143
8/12/2023,1,Agency_1,Saturday,34057,5678,None,1,56,39.74,91905,17296,37.06,26280,15086,43645,19909,37031.14286,10512.71429,39735,41366,63554,47543.85714
8/13/2023,1,Agency_1,Sunday,40786,8913,Concert,1,56,49.7,91905,17296,31.43,34057,5678,64375,15927,33661.28571,9510.714286,49699,39735,80302,43172
8/14/2023,1,Agency_1,Monday,38387,16445,Festival,1,56,54.83,91905,17296,27.35,40786,8913,54878,5328,31305.42857,11098.85714,54832,49699,60206,42404.28571
8/15/2023,1,Agency_1,Tuesday,15071,6008,None,0,56,21.08,91905,17296,46.32,38387,16445,22391,11633,30259.71429,10295.28571,21079,54832,34024,40555
8/16/2023,1,Agency_1,Wednesday,26022,5803,Concert,0,56,31.83,91905,17296,40.99,15071,6008,42744,11742,27870.85714,9446.857143,31825,21079,54486,37317.71429
8/17/2023,1,Agency_1,Thursday,29196,4979,Sports Event,0,56,34.18,91905,17296,39.98,26022,5803,14493,8195,29971.28571,8987.428571,34175,31825,22688,38958.71429
8/18/2023,1,Agency_1,Friday,25846,4426,Concert,0,56,30.27,91905,17296,42.04,29196,4979,26280,15086,29909.28571,7464.571429,30272,34175,41366,37373.85714
8/19/2023,1,Agency_1,Saturday,69785,15686,Sports Event,1,56,85.47,91905,17296,12.19,25846,4426,34057,5678,35013.28571,8894.285714,85471,30272,39735,43907.57143
8/20/2023,1,Agency_1,Sunday,38612,16791,Festival,1,56,55.4,91905,17296,27,69785,15686,40786,8913,34702.71429,10019.71429,55403,85471,49699,44722.42857
8/21/2023,1,Agency_1,Monday,29157,7748,Sports Event,0,56,36.91,91905,17296,38.06,38612,16791,38387,16445,33384.14286,8777.285714,36905,55403,54832,42161.42857
8/22/2023,1,Agency_1,Tuesday,44986,15505,Concert,1,56,60.49,91905,17296,24.71,29157,7748,15071,6008,37657.71429,10134,60491,36905,21079,47791.71429
8/23/2023,1,Agency_1,Wednesday,26020,6541,Sports Event,0,56,32.56,91905,17296,40.47,44986,15505,26022,5803,37657.42857,10239.42857,32561,60491,31825,47896.85714
8/24/2023,1,Agency_1,Thursday,36316,942,Sports Event,1,56,37.26,91905,17296,39.24,26020,6541,29196,4979,38674.57143,9662.714286,37258,32561,34175,48337.28571
8/25/2023,1,Agency_1,Friday,16151,10826,None,1,56,26.98,91905,17296,42.41,36316,942,25846,4426,37289.57143,10577,26977,37258,30272,47866.57143
8/26/2023,1,Agency_1,Saturday,66044,13926,Festival,1,56,79.97,91905,17296,15.29,16151,10826,69785,15686,36755.14286,10325.57143,79970,26977,85471,47080.71429
8/27/2023,1,Agency_1,Sunday,41187,12424,Sports Event,0,56,53.61,91905,17296,28.77,66044,13926,38612,16791,37123,9701.714286,53611,79970,55403,46824.71429
8/28/2023,1,Agency_1,Monday,53091,12306,Sports Event,0,56,65.4,91905,17296,22.9,41187,12424,29157,7748,40542.14286,10352.85714,65397,53611,36905,50895
8/29/2023,1,Agency_1,Tuesday,37752,7349,Festival,1,56,45.1,91905,17296,34.04,53091,12306,44986,15505,39508.71429,9187.714286,45101,65397,60491,48696.42857
8/30/2023,1,Agency_1,Wednesday,17950,9190,Sports Event,0,56,27.14,91905,17296,42.65,37752,7349,26020,6541,38355.85714,9566.142857,27140,45101,32561,47922
8/31/2023,1,Agency_1,Thursday,31625,5128,Sports Event,1,56,36.75,91905,17296,38.66,17950,9190,36316,942,37685.71429,10164.14286,36753,27140,37258,47849.85714
9/1/2023,1,Agency_1,Friday,25150,4821,Sports Event,0,56,29.97,91905,17296,42.11,31625,5128,16151,10826,38971.28571,9306.285714,29971,36753,26977,48277.57143
9/2/2023,1,Agency_1,Saturday,51183,14946,Sports Event,0,56,66.13,91905,17296,22.01,25150,4821,66044,13926,36848.28571,9452,66129,29971,79970,46300.28571
9/3/2023,1,Agency_1,Sunday,31137,14485,None,1,56,45.62,91905,17296,32.35,51183,14946,41187,12424,35412.57143,9746.428571,45622,66129,53611,45159
9/4/2023,1,Agency_1,Monday,20386,3277,None,0,56,23.66,91905,17296,45.57,31137,14485,53091,12306,30740.42857,8456.571429,23663,45622,65397,39197
9/5/2023,1,Agency_1,Tuesday,41422,10330,Sports Event,0,56,51.75,91905,17296,30.12,20386,3277,37752,7349,31264.71429,8882.428571,51752,23663,45101,40147.14286
9/6/2023,1,Agency_1,Wednesday,22219,7852,Sports Event,0,56,30.07,91905,17296,41.45,41422,10330,17950,9190,31874.57143,8691.285714,30071,51752,27140,40565.85714
9/7/2023,1,Agency_1,Thursday,20307,3127,None,1,56,23.43,91905,17296,45.72,22219,7852,31625,5128,30257.71429,8405.428571,23434,30071,36753,38663.14286
9/8/2023,1,Agency_1,Friday,48028,20986,Sports Event,1,56,69.02,91905,17296,19.35,20307,3127,25150,4821,33526,10714.71429,69014,23434,29971,44240.71429
9/9/2023,1,Agency_1,Saturday,30436,18950,Concert,1,56,49.39,91905,17296,29.58,48028,20986,51183,14946,30562.14286,11286.71429,49386,69014,66129,41848.85714
9/10/2023,1,Agency_1,Sunday,39185,12453,Festival,1,56,51.64,91905,17296,29.75,30436,18950,31137,14485,31711.85714,10996.42857,51638,49386,45622,42708.28571
9/11/2023,1,Agency_1,Monday,33224,7787,Sports Event,1,56,41.01,91905,17296,36,39185,12453,20386,3277,33545.85714,11640.71429,41011,51638,23663,45186.57143
9/12/2023,1,Agency_1,Tuesday,39471,7944,Sports Event,1,56,47.42,91905,17296,32.76,33224,7787,41422,10330,33267.14286,11299.85714,47415,41011,51752,44567
9/13/2023,1,Agency_1,Wednesday,27757,6858,None,1,56,34.62,91905,17296,39.38,39471,7944,22219,7852,34058.28571,11157.85714,34615,47415,30071,45216.14286
9/14/2023,1,Agency_1,Thursday,18805,3184,None,0,56,21.99,91905,17296,46.43,27757,6858,20307,3127,33843.71429,11166,21989,34615,23434,45009.71429
9/15/2023,1,Agency_1,Friday,25674,11067,Festival,0,56,36.74,91905,17296,37.48,18805,3184,48028,20986,30650.28571,9749,36741,21989,69014,40399.28571
9/16/2023,1,Agency_1,Saturday,27004,3957,None,0,56,30.96,91905,17296,41.79,25674,11067,30436,18950,30160,7607.142857,30961,36741,49386,37767.14286
9/17/2023,1,Agency_1,Sunday,24595,8452,None,0,56,33.05,91905,17296,39.85,27004,3957,39185,12453,28075.71429,7035.571429,33047,30961,51638,35111.28571
9/18/2023,1,Agency_1,Monday,17478,10346,Concert,0,56,27.82,91905,17296,42.08,24595,8452,33224,7787,25826.28571,7401.142857,27824,33047,41011,33227.42857
9/19/2023,1,Agency_1,Tuesday,25029,10439,Concert,0,56,35.47,91905,17296,38.24,17478,10346,39471,7944,23763.14286,7757.571429,35468,27824,47415,31520.71429
9/20/2023,1,Agency_1,Wednesday,31556,3308,Concert,1,56,34.87,91905,17296,39.97,25029,10439,27757,6858,24305.85714,7250.428571,34864,35468,34615,31556.28571
9/21/2023,1,Agency_1,Thursday,11862,5096,None,0,56,16.96,91905,17296,48.56,31556,3308,18805,3184,23314,7523.571429,16958,34864,21989,30837.57143
9/22/2023,1,Agency_1,Friday,41531,7594,Sports Event,1,56,49.13,91905,17296,31.98,11862,5096,25674,11067,25579.28571,7027.428571,49125,16958,36741,32606.71429
9/23/2023,1,Agency_1,Saturday,41745,3703,Festival,0,56,45.45,91905,17296,34.59,41531,7594,27004,3957,27685.14286,6991.142857,45448,49125,30961,34676.28571
9/24/2023,1,Agency_1,Sunday,23602,3350,None,0,56,26.95,91905,17296,43.91,41745,3703,24595,8452,27543.28571,6262.285714,26952,45448,33047,33805.57143
9/25/2023,1,Agency_1,Monday,25110,8659,Festival,0,56,33.77,91905,17296,39.44,23602,3350,17478,10346,28633.57143,6021.285714,33769,26952,27824,34654.85714
9/26/2023,1,Agency_1,Tuesday,20406,5922,None,1,56,26.33,91905,17296,43.71,25110,8659,25029,10439,27973.14286,5376,26328,33769,35468,33349.14286
9/27/2023,1,Agency_1,Wednesday,48810,9153,Sports Event,1,56,57.96,91905,17296,27.25,20406,5922,31556,3308,30438,6211,57963,26328,34864,36649
9/28/2023,1,Agency_1,Thursday,36267,4658,Concert,0,56,40.93,91905,17296,36.67,48810,9153,11862,5096,33924.42857,6148.428571,40925,57963,16958,40072.85714
9/29/2023,1,Agency_1,Friday,33973,13401,Concert,0,56,47.37,91905,17296,31.69,36267,4658,41531,7594,32844.71429,6978,47374,40925,49125,39822.71429
9/30/2023,1,Agency_1,Saturday,13753,7527,Festival,0,56,21.28,91905,17296,45.91,33973,13401,41745,3703,28845.85714,7524.285714,21280,47374,45448,36370.14286
10/1/2023,1,Agency_1,Sunday,35700,8359,None,1,56,44.06,91905,17296,34.36,13753,7527,23602,3350,30574.14286,8239.857143,44059,21280,26952,38814
10/2/2023,1,Agency_1,Monday,42617,9024,Sports Event,1,56,51.64,91905,17296,30.43,35700,8359,25110,8659,33075.14286,8292,51641,44059,33769,41367.14286
10/3/2023,1,Agency_1,Tuesday,26561,6563,None,1,56,33.12,91905,17296,40.18,42617,9024,20406,5922,33954.42857,8383.571429,33124,51641,26328,42338
10/4/2023,1,Agency_1,Wednesday,33589,7711,None,1,56,41.3,91905,17296,35.87,26561,6563,48810,9153,31780,8177.571429,41300,33124,57963,39957.57143
10/5/2023,1,Agency_1,Thursday,32532,7099,Sports Event,0,56,39.63,91905,17296,36.82,33589,7711,36267,4658,31246.42857,8526.285714,39631,41300,40925,39772.71429
10/6/2023,1,Agency_1,Friday,34243,9838,Sports Event,1,56,44.08,91905,17296,34.05,32532,7099,33973,13401,31285,8017.285714,44081,39631,47374,39302.28571
10/7/2023,1,Agency_1,Saturday,39549,9189,Sports Event,0,56,48.74,91905,17296,31.85,34243,9838,13753,7527,34970.14286,8254.714286,48738,44081,21280,43224.85714
10/8/2023,1,Agency_1,Sunday,38606,20221,Sports Event,0,56,58.83,91905,17296,24.6,39549,9189,35700,8359,35385.28571,9949.285714,58827,48738,44059,45334.57143
10/9/2023,1,Agency_1,Monday,47492,10345,Festival,1,56,57.84,91905,17296,27.07,38606,20221,42617,9024,36081.71429,10138,57837,58827,51641,46219.71429
10/10/2023,1,Agency_1,Tuesday,50711,9955,Sports Event,1,56,60.67,91905,17296,25.73,47492,10345,26561,6563,39531.71429,10622.57143,60666,57837,33124,50154.28571
10/11/2023,1,Agency_1,Wednesday,19127,7099,Festival,1,56,26.23,91905,17296,43.53,50711,9955,33589,7711,37465.71429,10535.14286,26226,60666,41300,48000.85714
10/12/2023,1,Agency_1,Thursday,15969,7303,Concert,0,56,23.27,91905,17296,44.96,19127,7099,32532,7099,35099.57143,10564.28571,23272,26226,39631,45663.85714
10/13/2023,1,Agency_1,Friday,39179,19877,Festival,1,56,59.06,91905,17296,24.56,15969,7303,34243,9838,35804.71429,11998.42857,59056,23272,44081,47803.14286
10/14/2023,1,Agency_1,Saturday,50623,14111,Concert,1,56,64.74,91905,17296,22.87,39179,19877,39549,9189,37386.71429,12701.57143,64734,59056,48738,50088.28571
10/15/2023,1,Agency_1,Sunday,56503,1785,Sports Event,1,56,58.29,91905,17296,28.56,50623,14111,38606,20221,39943.42857,10067.85714,58288,64734,58827,50011.28571
10/16/2023,1,Agency_1,Monday,27531,9157,None,1,56,36.69,91905,17296,37.88,56503,1785,47492,10345,37091.85714,9898.142857,36688,58288,57837,46990
10/17/2023,1,Agency_1,Tuesday,18910,12387,Festival,0,56,31.3,91905,17296,39.93,27531,9157,50711,9955,32548.85714,10245.57143,31297,36688,60666,42794.42857
10/18/2023,1,Agency_1,Wednesday,32538,7087,Sports Event,0,56,39.63,91905,17296,36.83,18910,12387,19127,7099,34464.71429,10243.85714,39625,31297,26226,44708.57143
10/19/2023,1,Agency_1,Thursday,45167,22707,Festival,1,56,67.88,91905,17296,19.58,32538,7087,15969,7303,38635.85714,12444.42857,67874,39625,23272,51080.28571
10/20/2023,1,Agency_1,Friday,40772,13080,Festival,1,56,53.85,91905,17296,28.52,45167,22707,39179,19877,38863.42857,11473.42857,53852,67874,59056,50336.85714
10/21/2023,1,Agency_1,Saturday,31865,7293,Festival,0,56,39.16,91905,17296,37.02,40772,13080,50623,14111,36183.71429,10499.42857,39158,53852,64734,46683.14286
10/22/2023,1,Agency_1,Sunday,43471,7264,Concert,0,56,50.74,91905,17296,31.24,31865,7293,56503,1785,34322,11282.14286,50735,39158,58288,45604.14286
10/23/2023,1,Agency_1,Monday,39696,9624,Concert,1,56,49.32,91905,17296,31.47,43471,7264,27531,9157,36059.85714,11348.85714,49320,50735,36688,47408.71429
10/24/2023,1,Agency_1,Tuesday,33591,9633,Sports Event,0,56,43.22,91905,17296,34.52,39696,9624,18910,12387,38157.14286,10955.42857,43224,49320,31297,49112.57143
10/25/2023,1,Agency_1,Wednesday,49114,9470,Sports Event,1,56,58.58,91905,17296,26.87,33591,9633,32538,7087,40525.14286,11295.85714,58584,43224,39625,51821
10/26/2023,1,Agency_1,Thursday,27975,5171,Sports Event,0,56,33.15,91905,17296,40.45,49114,9470,45167,22707,38069.14286,8790.714286,33146,58584,67874,46859.85714
10/27/2023,1,Agency_1,Friday,23111,8055,None,1,56,31.17,91905,17296,40.87,27975,5171,40772,13080,35546.14286,8072.857143,31166,33146,53852,43619
10/28/2023,1,Agency_1,Saturday,55654,9761,Concert,1,56,65.42,91905,17296,23.4,23111,8055,31865,7293,38944.57143,8425.428571,65415,31166,39158,47370
10/29/2023,1,Agency_1,Sunday,56974,23857,Concert,1,56,80.83,91905,17296,12.87,55654,9761,43471,7264,40873.57143,10795.85714,80831,65415,50735,51669.42857
10/30/2023,1,Agency_1,Monday,43030,20832,Festival,1,56,63.86,91905,17296,21.96,56974,23857,39696,9624,41349.85714,12397,63862,80831,49320,53746.85714
10/31/2023,1,Agency_1,Tuesday,31455,5973,Festival,1,56,37.43,91905,17296,38.15,43030,20832,33591,9633,41044.71429,11874.14286,37428,63862,43224,52918.85714
11/1/2023,1,Agency_1,Wednesday,21656,19020,Festival,1,56,40.68,91905,17296,33.92,31455,5973,49114,9470,37122.14286,13238.42857,40676,37428,58584,50360.57143
11/2/2023,1,Agency_1,Thursday,45378,11633,Sports Event,1,56,57.01,91905,17296,27.23,21656,19020,27975,5171,39608.28571,14161.57143,57011,40676,33146,53769.85714
11/3/2023,1,Agency_1,Friday,41728,6542,Festival,1,56,48.27,91905,17296,32.62,45378,11633,23111,8055,42267.85714,13945.42857,48270,57011,31166,56213.28571
11/4/2023,1,Agency_1,Saturday,58010,11620,Concert,0,56,69.63,91905,17296,20.92,41728,6542,55654,9761,42604.42857,14211,69630,48270,65415,56815.42857
11/5/2023,1,Agency_1,Sunday,48077,19959,Concert,1,56,68.04,91905,17296,20.05,58010,11620,56974,23857,41333.42857,13654.14286,68036,69630,80831,54987.57143
11/6/2023,1,Agency_1,Monday,22405,5447,None,0,56,27.85,91905,17296,43.04,48077,19959,43030,20832,38387,11456.28571,27852,68036,63862,49843.28571
11/7/2023,1,Agency_1,Tuesday,24070,10101,Concert,0,56,34.17,91905,17296,38.95,22405,5447,31455,5973,37332,12046,34171,27852,37428,49378
11/8/2023,1,Agency_1,Wednesday,57349,18302,Sports Event,1,56,75.65,91905,17296,16.57,24070,10101,21656,19020,42431,11943.42857,75651,34171,40676,54374.42857
11/9/2023,1,Agency_1,Thursday,41947,6760,Festival,0,56,48.71,91905,17296,32.35,57349,18302,45378,11633,41940.85714,11247.28571,48707,75651,57011,53188.14286
11/10/2023,1,Agency_1,Friday,29349,11300,Concert,1,56,40.65,91905,17296,35.47,41947,6760,41728,6542,40172.42857,11927,40649,48707,48270,52099.42857
11/11/2023,1,Agency_1,Saturday,47450,22239,Concert,1,56,69.69,91905,17296,18.77,29349,11300,58010,11620,38663.85714,13444,69689,40649,69630,52107.85714
11/12/2023,1,Agency_1,Sunday,26996,24934,Concert,1,56,51.93,91905,17296,27.11,47450,22239,48077,19959,35652.28571,14154.71429,51930,69689,68036,49807
11/13/2023,1,Agency_1,Monday,19209,4146,None,0,56,23.36,91905,17296,45.55,26996,24934,22405,5447,35195.71429,13968.85714,23355,51930,27852,49164.57143
11/14/2023,1,Agency_1,Tuesday,22408,2873,Festival,0,56,25.28,91905,17296,44.84,19209,4146,24070,10101,34958.28571,12936.28571,25281,23355,34171,47894.57143
11/15/2023,1,Agency_1,Wednesday,31349,7204,None,1,56,38.55,91905,17296,37.34,22408,2873,57349,18302,31244,11350.85714,38553,25281,75651,42594.85714
11/16/2023,1,Agency_1,Thursday,26422,5733,Concert,1,56,32.16,91905,17296,40.84,31349,7204,41947,6760,29026.14286,11204.14286,32155,38553,48707,40230.28571
11/17/2023,1,Agency_1,Friday,18321,8338,None,0,56,26.66,91905,17296,43.06,26422,5733,29349,11300,27450.71429,10781,26659,32155,40649,38231.71429
11/18/2023,1,Agency_1,Saturday,43762,6166,Festival,1,56,49.93,91905,17296,31.86,18321,8338,47450,22239,26923.85714,8484.857143,49928,26659,69689,35408.71429
11/19/2023,1,Agency_1,Sunday,43924,13780,Sports Event,1,56,57.7,91905,17296,26.45,43762,6166,26996,24934,29342.14286,6891.428571,57704,49928,51930,36233.57143
11/20/2023,1,Agency_1,Monday,9772,8314,Festival,0,56,18.09,91905,17296,47.35,43924,13780,19209,4146,27994,7486.857143,18086,57704,23355,35480.85714
11/21/2023,1,Agency_1,Tuesday,24498,8948,None,1,56,33.45,91905,17296,39.55,9772,8314,22408,2873,28292.57143,8354.714286,33446,18086,25281,36647.28571
11/22/2023,1,Agency_1,Wednesday,43866,12330,Sports Event,0,56,56.2,91905,17296,27.5,24498,8948,31349,7204,30080.71429,9087,56196,33446,38553,39167.71429
11/23/2023,1,Agency_1,Thursday,24251,3900,None,1,56,28.15,91905,17296,43.2,43866,12330,26422,5733,29770.57143,8825.142857,28151,56196,32155,38595.71429
11/24/2023,1,Agency_1,Friday,49299,8700,Sports Event,0,56,58,91905,17296,27.32,24251,3900,18321,8338,34196,8876.857143,57999,28151,26659,43072.85714
11/25/2023,1,Agency_1,Saturday,24082,6436,None,0,56,30.52,91905,17296,41.51,49299,8700,43762,6166,31384.57143,8915.428571,30518,57999,49928,40300
11/26/2023,1,Agency_1,Sunday,49116,14575,Concert,1,56,63.69,91905,17296,23.3,24082,6436,43924,13780,32126.28571,9029,63691,30518,57704,41155.28571
11/27/2023,1,Agency_1,Monday,17131,3906,None,0,56,21.04,91905,17296,46.76,49116,14575,9772,8314,33177.57143,8399.285714,21037,63691,18086,41576.85714
11/28/2023,1,Agency_1,Tuesday,25786,5478,None,1,56,31.27,91905,17296,41.33,17131,3906,24498,8948,33361.57143,7903.571429,31264,21037,33446,41265.14286
11/29/2023,1,Agency_1,Wednesday,32048,12404,Concert,1,56,44.45,91905,17296,33.35,25786,5478,43866,12330,31673.28571,7914.142857,44452,31264,56196,39587.42857
11/30/2023,1,Agency_1,Thursday,36513,19056,Sports Event,1,56,55.57,91905,17296,26.46,32048,12404,24251,3900,33425,10079.28571,55569,44452,28151,43504.28571
12/1/2023,1,Agency_1,Friday,13152,17095,Festival,1,56,30.25,91905,17296,39.52,36513,19056,49299,8700,28261.14286,11278.57143,30247,55569,57999,39539.71429
12/2/2023,1,Agency_1,Saturday,47214,1885,Festival,0,56,49.1,91905,17296,33.13,13152,17095,24082,6436,31565.71429,10628.42857,49099,30247,30518,42194.14286
12/3/2023,1,Agency_1,Sunday,21943,5534,None,0,56,27.48,91905,17296,43.21,47214,1885,49116,14575,27683.85714,9336.857143,27477,49099,63691,37020.71429
12/4/2023,1,Agency_1,Monday,25275,8196,Concert,1,56,33.47,91905,17296,39.68,21943,5534,17131,3906,28847.28571,9949.714286,33471,27477,21037,38797
12/5/2023,1,Agency_1,Tuesday,14447,8504,None,0,56,22.95,91905,17296,44.88,25275,8196,25786,5478,27227.42857,10382,22951,33471,31264,37609.42857
12/6/2023,1,Agency_1,Wednesday,37017,12823,Concert,0,56,49.84,91905,17296,30.58,14447,8504,32048,12404,27937.28571,10441.85714,49840,22951,44452,38379.14286
12/7/2023,1,Agency_1,Thursday,23608,2741,None,0,56,26.35,91905,17296,44.34,37017,12823,36513,19056,26093.71429,8111.142857,26349,49840,55569,34204.85714
12/8/2023,1,Agency_1,Friday,22590,8369,None,1,56,30.96,91905,17296,40.91,23608,2741,13152,17095,27442,6864.571429,30959,26349,30247,34306.57143
12/9/2023,1,Agency_1,Saturday,32500,19878,Sports Event,1,56,52.38,91905,17296,27.89,22590,8369,47214,1885,25340,9435,52378,30959,49099,34775
12/10/2023,1,Agency_1,Sunday,33836,9392,Festival,0,56,43.23,91905,17296,34.57,32500,19878,21943,5534,27039,9986.142857,43228,52378,27477,37025.14286
12/11/2023,1,Agency_1,Monday,45930,14013,Concert,1,56,59.94,91905,17296,25.29,33836,9392,25275,8196,29989.71429,10817.14286,59943,43228,33471,40806.85714
12/12/2023,1,Agency_1,Tuesday,35480,17416,Festival,1,56,52.9,91905,17296,28.13,45930,14013,14447,8504,32994.42857,12090.28571,52896,59943,22951,45084.71429
12/13/2023,1,Agency_1,Wednesday,14594,6231,None,0,56,20.82,91905,17296,46.4,35480,17416,37017,12823,29791.14286,11148.57143,20825,52896,49840,40939.71429
12/14/2023,1,Agency_1,Thursday,34447,7446,Festival,0,56,41.89,91905,17296,35.62,14594,6231,23608,2741,31339.57143,11820.71429,41893,20825,26349,43160.28571
12/15/2023,1,Agency_1,Friday,32445,4244,Sports Event,0,56,36.69,91905,17296,38.87,34447,7446,22590,8369,32747.42857,11231.42857,36689,41893,30959,43978.85714
12/16/2023,1,Agency_1,Saturday,44316,10232,Concert,0,56,54.55,91905,17296,28.74,32445,4244,32500,19878,34435.42857,9853.428571,54548,36689,52378,44288.85714
12/17/2023,1,Agency_1,Sunday,31294,15686,Festival,0,56,46.98,91905,17296,31.43,44316,10232,33836,9392,34072.28571,10752.57143,46980,54548,43228,44824.85714
12/18/2023,1,Agency_1,Monday,16478,2183,None,0,56,18.66,91905,17296,48.29,31294,15686,45930,14013,29864.85714,9062.571429,18661,46980,59943,38927.42857
12/19/2023,1,Agency_1,Tuesday,23821,14784,Concert,1,56,38.61,91905,17296,35.8,16478,2183,35480,17416,28199.28571,8686.571429,38605,18661,52896,36885.85714
12/20/2023,1,Agency_1,Wednesday,26514,20251,Festival,1,56,46.77,91905,17296,30.63,23821,14784,14594,6231,29902.14286,10689.42857,46765,38605,20825,40591.57143
12/21/2023,1,Agency_1,Thursday,12467,11748,None,1,56,24.22,91905,17296,43.6,26514,20251,34447,7446,26762.14286,11304,24215,46765,41893,38066.14286
12/22/2023,1,Agency_1,Friday,41057,11438,Festival,1,56,52.5,91905,17296,29.52,12467,11748,32445,4244,27992.42857,12331.71429,52495,24215,36689,40324.14286
12/23/2023,1,Agency_1,Saturday,40423,17939,Festival,1,56,58.36,91905,17296,25.29,41057,11438,44316,10232,27436.28571,13432.71429,58362,52495,54548,40869
12/24/2023,1,Agency_1,Sunday,35659,15925,Sports Event,0,56,51.59,91905,17296,29.08,40423,17939,31294,15686,28059.85714,13466.85714,51584,58362,46980,41526.71429
12/25/2023,1,Agency_1,Monday,26742,7419,None,1,56,34.16,91905,17296,39.49,35659,15925,16478,2183,29526.14286,14214.85714,34161,51584,18661,43741
12/26/2023,1,Agency_1,Tuesday,35452,11628,Festival,1,56,47.08,91905,17296,32.19,26742,7419,23821,14784,31187.71429,13764,47080,34161,38605,44951.71429
12/27/2023,1,Agency_1,Wednesday,21539,1579,None,0,56,23.12,91905,17296,46.18,35452,11628,26514,20251,30477,11096.57143,23118,47080,46765,41573.57143
12/28/2023,1,Agency_1,Thursday,19888,11026,Concert,0,56,30.91,91905,17296,40.4,21539,1579,12467,11748,31537.14286,10993.42857,30914,23118,24215,42530.57143
12/29/2023,1,Agency_1,Friday,31281,7874,Festival,0,56,39.16,91905,17296,36.91,19888,11026,41057,11438,30140.57143,10484.28571,39155,30914,52495,40624.85714
12/30/2023,1,Agency_1,Saturday,47015,17620,Concert,1,56,64.64,91905,17296,22.22,31281,7874,40423,17939,31082.28571,10438.71429,64635,39155,58362,41521
12/31/2023,1,Agency_1,Sunday,40484,10652,Sports Event,1,56,51.14,91905,17296,30.36,47015,17620,35659,15925,31771.57143,9685.428571,51136,64635,51584,41457
1/8/2023,2,Agency_2,Sunday,35237,6457,None,1,161,41.69,61894,48360,42.66,39487,15630,37762,6725,39277.42857,10628.85714,41694,55117,44487,49906.28571
1/9/2023,2,Agency_2,Monday,27212,4884,None,1,161,32.1,61894,48360,47.77,35237,6457,42979,3793,37025,10784.71429,32096,41694,46772,47809.71429
1/10/2023,2,Agency_2,Tuesday,33036,5202,Festival,1,161,38.24,61894,48360,44.64,27212,4884,49032,14149,34739.85714,9506.571429,38238,32096,63181,44246.42857
1/11/2023,2,Agency_2,Wednesday,19997,3214,None,1,161,23.21,61894,48360,52.55,33036,5202,31920,11840,33036.57143,8274.285714,23211,38238,43760,41310.85714
1/12/2023,2,Agency_2,Thursday,19656,9949,None,1,161,29.61,61894,48360,48.01,19997,3214,55237,16726,27953.57143,7306.142857,29605,23211,71963,35259.71429
1/13/2023,2,Agency_2,Friday,22879,17448,Sports Event,0,161,40.33,61894,48360,41.15,19656,9949,21050,5807,28214.85714,8969.142857,40327,29605,26857,37184
1/14/2023,2,Agency_2,Saturday,52570,16611,Concert,1,161,69.18,61894,48360,26.89,22879,17448,39487,15630,30083.85714,9109.285714,69181,40327,55117,39193.14286
1/15/2023,2,Agency_2,Sunday,36756,19801,Sports Event,1,161,56.56,61894,48360,32.56,52570,16611,35237,6457,30300.85714,11015.57143,56557,69181,41694,41316.42857
1/16/2023,2,Agency_2,Monday,17121,5244,None,0,161,22.37,61894,48360,52.57,36756,19801,27212,4884,28859.28571,11067,22365,56557,32096,39926.28571
1/17/2023,2,Agency_2,Tuesday,49200,8171,Festival,0,161,57.37,61894,48360,34.48,17121,5244,33036,5202,31168.42857,11491.14286,57371,22365,38238,42659.57143
1/18/2023,2,Agency_2,Wednesday,50204,8551,Festival,1,161,58.76,61894,48360,33.71,49200,8171,19997,3214,35483.71429,12253.57143,58755,57371,23211,47737.28571
1/19/2023,2,Agency_2,Thursday,29737,14519,Sports Event,0,161,44.26,61894,48360,39.77,50204,8551,19656,9949,36923.85714,12906.42857,44256,58755,29605,49830.28571
1/20/2023,2,Agency_2,Friday,16865,8624,None,0,161,25.49,61894,48360,50.33,29737,14519,22879,17448,36064.71429,11645.85714,25489,44256,40327,47710.57143
1/21/2023,2,Agency_2,Saturday,55078,11989,Concert,1,161,67.07,61894,48360,28.87,16865,8624,52570,16611,36423,10985.57143,67067,25489,69181,47408.57143
1/22/2023,2,Agency_2,Sunday,36132,12639,None,1,161,48.77,61894,48360,37.88,55078,11989,36756,19801,36333.85714,9962.428571,48771,67067,56557,46296.28571
1/23/2023,2,Agency_2,Monday,23109,1859,None,0,161,24.97,61894,48360,51.94,36132,12639,17121,5244,37189.28571,9478.857143,24968,48771,22365,46668.14286
1/24/2023,2,Agency_2,Tuesday,21273,6305,None,1,161,27.58,61894,48360,49.75,23109,1859,49200,8171,33199.71429,9212.285714,27578,24968,57371,42412
1/25/2023,2,Agency_2,Wednesday,19627,6241,None,0,161,25.87,61894,48360,50.62,21273,6305,50204,8551,28831.57143,8882.285714,25868,27578,58755,37713.85714
1/26/2023,2,Agency_2,Thursday,40731,5543,Sports Event,1,161,46.27,61894,48360,40.55,19627,6241,29737,14519,30402.14286,7600,46274,25868,44256,38002.14286
1/27/2023,2,Agency_2,Friday,42705,14805,Festival,1,161,57.51,61894,48360,33.08,40731,5543,16865,8624,34093.57143,8483,57510,46274,25489,42576.57143
1/28/2023,2,Agency_2,Saturday,53347,22156,Sports Event,1,161,75.5,61894,48360,22.62,42705,14805,55078,11989,33846.28571,9935.428571,75503,57510,67067,43781.71429
1/29/2023,2,Agency_2,Sunday,56555,18310,Concert,1,161,74.87,61894,48360,23.7,53347,22156,36132,12639,36763.85714,10745.57143,74865,75503,48771,47509.42857
1/30/2023,2,Agency_2,Monday,38315,3993,Concert,1,161,42.31,61894,48360,42.85,56555,18310,23109,1859,38936.14286,11050.42857,42308,74865,24968,49986.57143
1/31/2023,2,Agency_2,Tuesday,33222,9205,Concert,0,161,42.43,61894,48360,41.74,38315,3993,21273,6305,40643.14286,11464.71429,42427,42308,27578,52107.85714
2/1/2023,2,Agency_2,Wednesday,27764,3424,None,1,161,31.19,61894,48360,48.52,33222,9205,19627,6241,41805.57143,11062.28571,31188,42427,25868,52867.85714
2/2/2023,2,Agency_2,Thursday,28458,16912,Sports Event,1,161,45.37,61894,48360,38.73,27764,3424,40731,5543,40052.28571,12686.42857,45370,31188,46274,52738.71429
2/3/2023,2,Agency_2,Friday,29703,10817,Festival,0,161,40.52,61894,48360,42.38,28458,16912,42705,14805,38194.85714,12116.71429,40520,45370,57510,50311.57143
2/4/2023,2,Agency_2,Saturday,47129,15652,Festival,1,161,62.78,61894,48360,30.28,29703,10817,53347,22156,37306.57143,11187.57143,62781,40520,75503,48494.14286
2/5/2023,2,Agency_2,Sunday,44443,8767,Sports Event,0,161,53.21,61894,48360,36.44,47129,15652,56555,18310,35576.28571,9824.285714,53210,62781,74865,45400.57143
2/6/2023,2,Agency_2,Monday,39936,9698,Sports Event,1,161,49.63,61894,48360,38.04,44443,8767,38315,3993,35807.85714,10639.28571,49634,53210,42308,46447.14286
2/7/2023,2,Agency_2,Tuesday,34762,10426,Festival,1,161,45.19,61894,48360,40.12,39936,9698,33222,9205,36027.85714,10813.71429,45188,49634,42427,46841.57143
2/8/2023,2,Agency_2,Wednesday,41164,9619,Sports Event,1,161,50.78,61894,48360,37.48,34762,10426,27764,3424,37942.14286,11698.71429,50783,45188,31188,49640.85714
2/9/2023,2,Agency_2,Thursday,39417,5457,Festival,0,161,44.87,61894,48360,41.27,41164,9619,28458,16912,39507.71429,10062.28571,44874,50783,45370,49570
2/10/2023,2,Agency_2,Friday,37176,9805,Concert,1,161,46.98,61894,48360,39.35,39417,5457,29703,10817,40575.28571,9917.714286,46981,44874,40520,50493
2/11/2023,2,Agency_2,Saturday,63727,16685,Concert,1,161,80.41,61894,48360,21.26,37176,9805,47129,15652,42946.42857,10065.28571,80412,46981,62781,53011.71429
2/12/2023,2,Agency_2,Sunday,39248,3690,None,1,161,42.94,61894,48360,42.59,63727,16685,44443,8767,42204.28571,9340,42938,80412,53210,51544.28571
2/13/2023,2,Agency_2,Monday,41603,16134,Sports Event,1,161,57.74,61894,48360,32.7,39248,3690,39936,9698,42442.42857,10259.42857,57737,42938,49634,52701.85714
2/14/2023,2,Agency_2,Tuesday,30616,12121,Sports Event,0,161,42.74,61894,48360,41.01,41603,16134,34762,10426,41850.14286,10501.57143,42737,57737,45188,52351.71429
2/15/2023,2,Agency_2,Wednesday,26119,13290,Sports Event,0,161,39.41,61894,48360,42.44,30616,12121,41164,9619,39700.85714,11026,39409,42737,50783,50726.85714
2/16/2023,2,Agency_2,Thursday,61413,10172,Concert,1,161,71.59,61894,48360,26.97,26119,13290,39417,5457,42843.14286,11699.57143,71585,39409,44874,54542.71429
2/17/2023,2,Agency_2,Friday,23103,11068,None,1,161,34.17,61894,48360,45.5,61413,10172,37176,9805,40832.71429,11880,34171,71585,46981,52712.71429
2/18/2023,2,Agency_2,Saturday,43519,7196,None,1,161,50.72,61894,48360,38,23103,11068,63727,16685,37945.85714,10524.42857,50715,34171,80412,48470.28571
2/19/2023,2,Agency_2,Sunday,21478,5766,None,0,161,27.25,61894,48360,50.02,43519,7196,39248,3690,35407.28571,10821,27244,50715,42938,46228.28571
2/20/2023,2,Agency_2,Monday,19915,5375,Sports Event,0,161,25.29,61894,48360,51.08,21478,5766,41603,16134,32309,9284,25290,27244,57737,41593
2/21/2023,2,Agency_2,Tuesday,19472,4849,None,1,161,24.32,61894,48360,51.67,19915,5375,30616,12121,30717,8245.142857,24321,25290,42737,38962.14286
2/22/2023,2,Agency_2,Wednesday,38660,13013,Festival,1,161,51.67,61894,48360,36.36,19472,4849,26119,13290,32508.57143,8205.571429,51673,24321,39409,40714.14286
2/23/2023,2,Agency_2,Thursday,41628,5105,Sports Event,0,161,46.73,61894,48360,40.41,38660,13013,61413,10172,29682.14286,7481.714286,46733,51673,71585,37163.85714
2/24/2023,2,Agency_2,Friday,48595,10881,Festival,1,161,59.48,61894,48360,32.88,41628,5105,23103,11068,33323.85714,7455,59476,46733,34171,40778.85714
2/25/2023,2,Agency_2,Saturday,46219,19643,Festival,1,161,65.86,61894,48360,27.94,48595,10881,43519,7196,33709.57143,9233.142857,65862,59476,50715,42942.71429
2/26/2023,2,Agency_2,Sunday,17263,7493,None,0,161,24.76,61894,48360,50.92,46219,19643,21478,5766,33107.42857,9479.857143,24756,65862,27244,42587.28571
2/27/2023,2,Agency_2,Monday,40622,14241,Concert,1,161,54.86,61894,48360,34.52,17263,7493,19915,5375,36065.57143,10746.42857,54863,24756,25290,46812
2/28/2023,2,Agency_2,Tuesday,32167,16847,Concert,0,161,49.01,61894,48360,36.92,40622,14241,19472,4849,37879.14286,12460.42857,49014,54863,24321,50339.57143
3/1/2023,2,Agency_2,Wednesday,25216,6694,Sports Event,0,161,31.91,61894,48360,47.5,32167,16847,38660,13013,35958.57143,11557.71429,31910,49014,51673,47516.28571
3/2/2023,2,Agency_2,Thursday,21949,5444,None,1,161,27.39,61894,48360,50.01,25216,6694,41628,5105,33147.28571,11606.14286,27393,31910,46733,44753.42857
3/3/2023,2,Agency_2,Friday,32785,17559,Concert,1,161,50.34,61894,48360,36.11,21949,5444,48595,10881,30888.71429,12560.14286,50344,27393,59476,43448.85714
3/4/2023,2,Agency_2,Saturday,32522,5015,None,0,161,37.54,61894,48360,45.03,32785,17559,46219,19643,28932,10470.42857,37537,50344,65862,39402.42857
3/5/2023,2,Agency_2,Sunday,28508,13131,Festival,0,161,41.64,61894,48360,41.35,32522,5015,17263,7493,30538.42857,11275.85714,41639,37537,24756,41814.28571
3/6/2023,2,Agency_2,Monday,33614,14910,Festival,1,161,48.52,61894,48360,37.55,28508,13131,40622,14241,29537.28571,11371.42857,48524,41639,54863,40908.71429
3/7/2023,2,Agency_2,Tuesday,40977,4683,Festival,1,161,45.66,61894,48360,41.03,33614,14910,32167,16847,30795.85714,9633.714286,45660,48524,49014,40429.57143
3/8/2023,2,Agency_2,Wednesday,41605,14604,Concert,0,161,56.21,61894,48360,33.77,40977,4683,25216,6694,33137.14286,10763.71429,56209,45660,31910,43900.85714
3/9/2023,2,Agency_2,Thursday,25404,7180,Sports Event,0,161,32.58,61894,48360,47.07,41605,14604,21949,5444,33630.71429,11011.71429,32584,56209,27393,44642.42857
3/10/2023,2,Agency_2,Friday,32143,9635,Concert,0,161,41.78,61894,48360,41.98,25404,7180,32785,17559,33539,9879.714286,41778,32584,50344,43418.71429
3/11/2023,2,Agency_2,Saturday,36335,16416,None,1,161,52.75,61894,48360,35.14,32143,9635,32522,5015,34083.71429,11508.42857,52751,41778,37537,45592.14286
3/12/2023,2,Agency_2,Sunday,44729,10528,Concert,1,161,55.26,61894,48360,35.06,36335,16416,28508,13131,36401,11136.57143,55257,52751,41639,47537.57143
3/13/2023,2,Agency_2,Monday,19654,6014,Concert,0,161,25.67,61894,48360,50.76,44729,10528,33614,14910,34406.71429,9865.714286,25668,55257,48524,44272.42857
3/14/2023,2,Agency_2,Tuesday,38676,20441,Sports Event,1,161,59.12,61894,48360,31.15,19654,6014,40977,4683,34078,12116.85714,59117,25668,45660,46194.85714
3/15/2023,2,Agency_2,Wednesday,33951,12963,Sports Event,1,161,46.92,61894,48360,38.75,38676,20441,41605,14604,32984.57143,11882.42857,46914,59117,56209,44867
3/16/2023,2,Agency_2,Thursday,25892,10326,None,1,161,36.22,61894,48360,44.62,33951,12963,25404,7180,33054.28571,12331.85714,36218,46914,32584,45386.14286
3/17/2023,2,Agency_2,Friday,48951,6694,Festival,0,161,55.65,61894,48360,35.64,25892,10326,32143,9635,35455.42857,11911.71429,55645,36218,41778,47367.14286
3/18/2023,2,Agency_2,Saturday,27381,12900,None,1,161,40.28,61894,48360,42.08,48951,6694,36335,16416,34176.28571,11409.42857,40281,55645,52751,45585.71429
3/19/2023,2,Agency_2,Sunday,54777,26896,Festival,1,161,81.67,61894,48360,18.58,27381,12900,44729,10528,35611.71429,13747.71429,81673,40281,55257,49359.42857
3/20/2023,2,Agency_2,Monday,44692,10188,Sports Event,1,161,54.88,61894,48360,35.32,54777,26896,19654,6014,39188.57143,14344,54880,81673,25668,53532.57143
3/21/2023,2,Agency_2,Tuesday,44758,17176,Sports Event,1,161,61.93,61894,48360,30.4,44692,10188,38676,20441,40057.42857,13877.57143,61934,54880,59117,53935
3/22/2023,2,Agency_2,Wednesday,46998,14313,Concert,1,161,61.31,61894,48360,31.28,44758,17176,33951,12963,41921.28571,14070.42857,61311,61934,46914,55991.71429
3/23/2023,2,Agency_2,Thursday,37999,12474,Sports Event,0,161,50.47,61894,48360,37.07,46998,14313,25892,10326,43650.85714,14377.28571,50473,61311,36218,58028.14286
3/24/2023,2,Agency_2,Friday,52474,14986,Concert,1,161,67.46,61894,48360,28.07,37999,12474,48951,6694,44154.14286,15561.85714,67460,50473,55645,59716
3/25/2023,2,Agency_2,Saturday,44843,16376,Festival,1,161,61.22,61894,48360,30.91,52474,14986,27381,12900,46648.71429,16058.42857,61219,67460,40281,62707.14286
3/26/2023,2,Agency_2,Sunday,46857,7438,Festival,0,161,54.3,61894,48360,36.16,44843,16376,54777,26896,45517.28571,13278.71429,54295,61219,81673,58796
3/27/2023,2,Agency_2,Monday,42593,10026,Sports Event,1,161,52.62,61894,48360,36.48,46857,7438,44692,10188,45217.42857,13255.57143,52619,54295,54880,58473
3/28/2023,2,Agency_2,Tuesday,20143,7556,None,0,161,27.7,61894,48360,49.44,42593,10026,44758,17176,41701,11881.28571,27699,52619,61934,53582.28571
3/29/2023,2,Agency_2,Wednesday,40862,12118,Sports Event,1,161,52.98,61894,48360,35.88,20143,7556,46998,14313,40824.42857,11567.71429,52980,27699,61311,52392.14286
3/30/2023,2,Agency_2,Thursday,25740,15450,Concert,1,161,41.19,61894,48360,41.11,40862,12118,37999,12474,39073.14286,11992.85714,41190,52980,50473,51066
3/31/2023,2,Agency_2,Friday,34840,15854,Concert,0,161,50.69,61894,48360,36.28,25740,15450,52474,14986,36554,12116.85714,50694,41190,67460,48670.85714
4/1/2023,2,Agency_2,Saturday,33229,12017,Festival,0,161,45.25,61894,48360,39.77,34840,15854,44843,16376,34894.85714,11494.14286,45246,50694,61219,46389
4/2/2023,2,Agency_2,Sunday,25495,10600,None,0,161,36.1,61894,48360,44.63,33229,12017,46857,7438,31843.14286,11945.85714,36095,45246,54295,43789
4/3/2023,2,Agency_2,Monday,38069,13228,Festival,1,161,51.3,61894,48360,36.5,25495,10600,42593,10026,31196.85714,12403.28571,51297,36095,52619,43600.14286
4/4/2023,2,Agency_2,Tuesday,29950,7522,None,1,161,37.47,61894,48360,44.56,38069,13228,20143,7556,32597.85714,12398.42857,37472,51297,27699,44996.28571
4/5/2023,2,Agency_2,Wednesday,26650,9159,Concert,0,161,35.81,61894,48360,45.06,29950,7522,40862,12118,30567.57143,11975.71429,35809,37472,52980,42543.28571
4/6/2023,2,Agency_2,Thursday,49467,7011,Festival,1,161,56.48,61894,48360,35.16,26650,9159,25740,15450,33957.14286,10770.14286,56478,35809,41190,44727.28571
4/7/2023,2,Agency_2,Friday,30996,6118,Sports Event,0,161,37.11,61894,48360,45.02,49467,7011,34840,15854,33408,9379.285714,37114,56478,50694,42787.28571
4/8/2023,2,Agency_2,Saturday,46755,4316,Concert,0,161,51.07,61894,48360,38.4,30996,6118,33229,12017,35340.28571,8279.142857,51071,37114,45246,43619.42857
4/9/2023,2,Agency_2,Sunday,40259,17802,Festival,1,161,58.06,61894,48360,32.21,46755,4316,25495,10600,37449.42857,9308,58061,51071,36095,46757.42857
4/10/2023,2,Agency_2,Monday,54262,11585,Concert,1,161,65.85,61894,48360,29.56,40259,17802,38069,13228,39762.71429,9073.285714,65847,58061,51297,48836
4/11/2023,2,Agency_2,Tuesday,33586,20853,Sports Event,1,161,54.44,61894,48360,33.41,54262,11585,29950,7522,40282.14286,10977.71429,54439,65847,37472,51259.85714
4/12/2023,2,Agency_2,Wednesday,19138,1023,Festival,0,161,20.16,61894,48360,54.51,33586,20853,26650,9159,39209,9815.428571,20161,54439,35809,49024.42857
4/13/2023,2,Agency_2,Thursday,33300,6791,Sports Event,0,161,40.09,61894,48360,43.39,19138,1023,49467,7011,36899.42857,9784,40091,20161,56478,46683.42857
4/14/2023,2,Agency_2,Friday,22339,10907,Concert,0,161,33.25,61894,48360,45.99,33300,6791,30996,6118,35662.71429,10468.14286,33246,40091,37114,46130.85714
4/15/2023,2,Agency_2,Saturday,49652,11976,Sports Event,1,161,61.63,61894,48360,31.59,22339,10907,46755,4316,36076.57143,11562.42857,61628,33246,51071,47639
4/16/2023,2,Agency_2,Sunday,21212,12274,None,1,161,33.49,61894,48360,45.6,49652,11976,40259,17802,33355.57143,10772.71429,33486,61628,58061,44128.28571
4/17/2023,2,Agency_2,Monday,30226,6721,None,1,161,36.95,61894,48360,44.98,21212,12274,54262,11585,29921.85714,10077.85714,36947,33486,65847,39999.71429
4/18/2023,2,Agency_2,Tuesday,38002,4002,None,1,161,42.01,61894,48360,43,30226,6721,33586,20853,30552.71429,7670.571429,42004,36947,54439,38223.28571
4/19/2023,2,Agency_2,Wednesday,24125,8606,Festival,1,161,32.73,61894,48360,46.71,38002,4002,19138,1023,31265.14286,8753.857143,32731,42004,20161,40019
4/20/2023,2,Agency_2,Thursday,38555,13056,Sports Event,1,161,51.61,61894,48360,36.38,24125,8606,33300,6791,32015.85714,9648.857143,51611,32731,40091,41664.71429
4/21/2023,2,Agency_2,Friday,18793,5704,None,0,161,24.5,61894,48360,51.41,38555,13056,22339,10907,31509.28571,8905.571429,24497,51611,33246,40414.85714
4/22/2023,2,Agency_2,Saturday,24735,17430,Sports Event,0,161,42.17,61894,48360,40.23,18793,5704,49652,11976,27949.71429,9684.714286,42165,24497,61628,37634.42857
4/23/2023,2,Agency_2,Sunday,35260,15987,Festival,0,161,51.25,61894,48360,35.98,24735,17430,21212,12274,29956.57143,10215.14286,51247,42165,33486,40171.71429
4/24/2023,2,Agency_2,Monday,28226,8278,None,1,161,36.51,61894,48360,44.89,35260,15987,30226,6721,29670.85714,10437.57143,36504,51247,36947,40108.42857
4/25/2023,2,Agency_2,Tuesday,44553,14030,Festival,1,161,58.58,61894,48360,32.7,28226,8278,38002,4002,30606.71429,11870.14286,58583,36504,42004,42476.85714
4/26/2023,2,Agency_2,Wednesday,23213,7658,None,0,161,30.87,61894,48360,47.83,44553,14030,24125,8606,30476.42857,11734.71429,30871,58583,32731,42211.14286
4/27/2023,2,Agency_2,Thursday,20982,6418,None,0,161,27.4,61894,48360,49.82,23213,7658,38555,13056,27966,10786.42857,27400,30871,51611,38752.42857
4/28/2023,2,Agency_2,Friday,38124,18754,Festival,1,161,56.88,61894,48360,32.61,20982,6418,18793,5704,30727.57143,12650.71429,56878,27400,24497,43378.28571
4/29/2023,2,Agency_2,Saturday,19941,11181,None,0,161,31.12,61894,48360,47,38124,18754,24735,17430,30042.71429,11758,31122,56878,42165,41800.71429
4/30/2023,2,Agency_2,Sunday,35638,4724,Concert,0,161,40.36,61894,48360,43.67,19941,11181,35260,15987,30096.71429,10149,40362,31122,51247,40245.71429
5/1/2023,2,Agency_2,Monday,40248,8656,Sports Event,1,161,48.9,61894,48360,38.62,35638,4724,28226,8278,31814.14286,10203,48904,40362,36504,42017.14286
5/2/2023,2,Agency_2,Tuesday,47195,8791,Festival,1,161,55.99,61894,48360,35.05,40248,8656,44553,14030,32191.57143,9454.571429,55986,48904,58583,41646.14286
5/3/2023,2,Agency_2,Wednesday,34649,2903,Concert,1,161,37.55,61894,48360,45.44,47195,8791,23213,7658,33825.28571,8775.285714,37552,55986,30871,42600.57143
5/4/2023,2,Agency_2,Thursday,23059,212,None,1,161,23.27,61894,48360,53.12,34649,2903,20982,6418,34122,7888.714286,23271,37552,27400,42010.71429
5/5/2023,2,Agency_2,Friday,23556,15517,Sports Event,1,161,39.07,61894,48360,42.16,23059,212,38124,18754,32040.85714,7426.285714,39073,23271,56878,39467.14286
5/6/2023,2,Agency_2,Saturday,37329,10647,None,1,161,47.98,61894,48360,38.68,23556,15517,19941,11181,34524.85714,7350,47976,39073,31122,41874.85714
5/7/2023,2,Agency_2,Sunday,35486,15172,Concert,1,161,50.66,61894,48360,36.43,37329,10647,35638,4724,34503.14286,8842.571429,50658,47976,40362,43345.71429
5/8/2023,2,Agency_2,Monday,29971,4561,Sports Event,0,161,34.53,61894,48360,46.62,35486,15172,40248,8656,33035,8257.571429,34532,50658,48904,41292.57143
5/9/2023,2,Agency_2,Tuesday,41274,11481,Festival,0,161,52.76,61894,48360,36.12,29971,4561,47195,8791,32189.14286,8641.857143,52755,34532,55986,40831
5/10/2023,2,Agency_2,Wednesday,36845,12026,Festival,1,161,48.87,61894,48360,37.96,41274,11481,34649,2903,32502.85714,9945.142857,48871,52755,37552,42448
5/11/2023,2,Agency_2,Thursday,27353,1282,None,1,161,28.64,61894,48360,50.22,36845,12026,23059,212,33116.28571,10098,28635,48871,23271,43214.28571
5/12/2023,2,Agency_2,Friday,28146,6181,Festival,0,161,34.33,61894,48360,46.4,27353,1282,23556,15517,33772,8764.285714,34327,28635,39073,42536.28571
5/13/2023,2,Agency_2,Saturday,23385,8075,None,1,161,31.46,61894,48360,47.45,28146,6181,37329,10647,31780,8396.857143,31460,34327,47976,40176.85714
5/14/2023,2,Agency_2,Sunday,34785,8165,None,0,161,42.95,61894,48360,41.69,23385,8075,35486,15172,31679.85714,7395.857143,42950,31460,50658,39075.71429
5/15/2023,2,Agency_2,Monday,17144,6145,None,0,161,23.29,61894,48360,51.93,34785,8165,29971,4561,29847.42857,7622.142857,23289,42950,34532,37469.57143
5/16/2023,2,Agency_2,Tuesday,40494,11643,Festival,0,161,52.14,61894,48360,36.4,17144,6145,41274,11481,29736,7645.285714,52137,23289,52755,37381.28571
5/17/2023,2,Agency_2,Wednesday,30447,6300,Concert,0,161,36.75,61894,48360,45.17,40494,11643,36845,12026,28822,6827.285714,36747,52137,48871,35649.28571
5/18/2023,2,Agency_2,Thursday,23491,5786,None,0,161,29.28,61894,48360,49,30447,6300,27353,1282,28270.28571,7470.714286,29277,36747,28635,35741
5/19/2023,2,Agency_2,Friday,36712,10659,Concert,0,161,47.37,61894,48360,38.98,23491,5786,28146,6181,29494,8110.428571,47371,29277,34327,37604.42857
5/20/2023,2,Agency_2,Saturday,45444,8683,Festival,0,161,54.13,61894,48360,36,36712,10659,23385,8075,32645.28571,8197.285714,54127,47371,31460,40842.57143
5/21/2023,2,Agency_2,Sunday,41474,9818,None,1,161,51.29,61894,48360,37.19,45444,8683,34785,8165,33600.85714,8433.428571,51292,54127,42950,42034.28571
5/22/2023,2,Agency_2,Monday,45564,6155,Concert,0,161,51.72,61894,48360,37.71,41474,9818,17144,6145,37660.85714,8434.857143,51719,51292,23289,46095.71429
5/23/2023,2,Agency_2,Tuesday,43018,9171,Festival,0,161,52.19,61894,48360,36.87,45564,6155,40494,11643,38021.42857,8081.714286,52189,51719,52137,46103.14286
5/24/2023,2,Agency_2,Wednesday,16742,4032,None,0,161,20.77,61894,48360,53.61,43018,9171,30447,6300,36063.57143,7757.714286,20774,52189,36747,43821.28571
5/25/2023,2,Agency_2,Thursday,27597,9941,Concert,0,161,37.54,61894,48360,44.04,16742,4032,23491,5786,36650.14286,8351.285714,37538,20774,29277,45001.42857
5/26/2023,2,Agency_2,Friday,33921,6548,Festival,0,161,40.47,61894,48360,43.25,27597,9941,36712,10659,36251.42857,7764,40469,37538,47371,44015.42857
5/27/2023,2,Agency_2,Saturday,35780,20517,Festival,0,161,56.3,61894,48360,32.55,33921,6548,45444,8683,34870.85714,9454.571429,56297,40469,54127,44325.42857
5/28/2023,2,Agency_2,Sunday,67010,18167,Concert,1,161,85.18,61894,48360,18.58,35780,20517,41474,9818,38518.85714,10647.28571,85177,56297,51292,49166.14286
5/29/2023,2,Agency_2,Monday,20190,5240,None,0,161,25.43,61894,48360,51.04,67010,18167,45564,6155,34894,10516.57143,25430,85177,51719,45410.57143
5/30/2023,2,Agency_2,Tuesday,34600,5021,Sports Event,0,161,39.62,61894,48360,43.98,20190,5240,43018,9171,33691.42857,9923.714286,39621,25430,52189,43615.14286
5/31/2023,2,Agency_2,Wednesday,24326,2326,None,1,161,26.65,61894,48360,51.01,34600,5021,16742,4032,34774.85714,9680,26652,39621,20774,44454.85714
6/1/2023,2,Agency_2,Thursday,42892,14979,Sports Event,1,161,57.87,61894,48360,32.87,24326,2326,27597,9941,36959.85714,10399.71429,57871,26652,37538,47359.57143
6/2/2023,2,Agency_2,Friday,22859,11405,None,1,161,34.27,61894,48360,45.39,42892,14979,33921,6548,35379.57143,11093.57143,34264,57871,40469,46473.14286
6/3/2023,2,Agency_2,Saturday,24967,4576,Concert,0,161,29.54,61894,48360,49.11,22859,11405,35780,20517,33834.85714,8816.285714,29543,34264,56297,42651.14286
6/4/2023,2,Agency_2,Sunday,49425,21948,Festival,1,161,71.37,61894,48360,24.72,24967,4576,67010,18167,31322.71429,9356.428571,71373,29543,85177,40679.14286
6/5/2023,2,Agency_2,Monday,28419,4082,None,0,161,32.5,61894,48360,47.73,49425,21948,20190,5240,32498.28571,9191,32501,71373,25430,41689.28571
6/6/2023,2,Agency_2,Tuesday,49516,11714,Sports Event,1,161,61.23,61894,48360,31.84,28419,4082,34600,5021,34629.14286,10147.14286,61230,32501,39621,44776.28571
6/7/2023,2,Agency_2,Wednesday,28704,11503,Sports Event,0,161,40.21,61894,48360,42.39,49516,11714,24326,2326,35254.57143,11458.14286,40207,61230,26652,46712.71429
6/8/2023,2,Agency_2,Thursday,45358,4395,Sports Event,1,161,49.75,61894,48360,39.04,28704,11503,42892,14979,35606.85714,9946.142857,49753,40207,57871,45553
6/9/2023,2,Agency_2,Friday,27382,7760,None,0,161,35.14,61894,48360,45.68,45358,4395,22859,11405,36253,9425.428571,35142,49753,34264,45678.42857
6/10/2023,2,Agency_2,Saturday,30369,12798,Festival,0,161,43.17,61894,48360,40.66,27382,7760,24967,4576,37024.71429,10600,43167,35142,29543,47624.71429
6/11/2023,2,Agency_2,Sunday,26964,7177,None,0,161,34.14,61894,48360,46.29,30369,12798,49425,21948,33816,8489.857143,34141,43167,71373,42305.85714
6/12/2023,2,Agency_2,Monday,33633,8701,Festival,1,161,42.33,61894,48360,41.89,26964,7177,28419,4082,34560.85714,9149.714286,42334,34141,32501,43710.57143
6/13/2023,2,Agency_2,Tuesday,38750,17481,Sports Event,1,161,56.23,61894,48360,33.19,33633,8701,49516,11714,33022.85714,9973.571429,56231,42334,61230,42996.42857
6/14/2023,2,Agency_2,Wednesday,44300,10134,Sports Event,1,161,54.43,61894,48360,35.56,38750,17481,28704,11503,35250.85714,9778,54434,56231,40207,45028.85714
6/15/2023,2,Agency_2,Thursday,23858,0,None,0,161,23.86,61894,48360,52.87,44300,10134,45358,4395,32179.42857,9150.142857,23858,54434,49753,41329.57143
6/16/2023,2,Agency_2,Friday,50198,3617,Concert,1,161,53.82,61894,48360,37.17,23858,0,27382,7760,35438.85714,8558.285714,53815,23858,35142,43997.14286
6/17/2023,2,Agency_2,Saturday,32736,6099,Sports Event,0,161,38.84,61894,48360,44.16,50198,3617,30369,12798,35777,7601.285714,38835,53815,43167,43378.28571
6/18/2023,2,Agency_2,Sunday,31650,22651,Sports Event,1,161,54.3,61894,48360,33.12,32736,6099,26964,7177,36446.42857,9811.857143,54301,38835,34141,46258.28571
6/19/2023,2,Agency_2,Monday,34438,13549,Sports Event,1,161,47.99,61894,48360,38.09,31650,22651,33633,8701,36561.42857,10504.42857,47987,54301,42334,47065.85714
6/20/2023,2,Agency_2,Tuesday,29647,10121,Sports Event,0,161,39.77,61894,48360,42.89,34438,13549,38750,17481,35261,9453,39768,47987,56231,44714
6/21/2023,2,Agency_2,Wednesday,39748,5792,Festival,1,161,45.54,61894,48360,40.87,29647,10121,44300,10134,34610.71429,8832.714286,45540,39768,54434,43443.42857
6/22/2023,2,Agency_2,Thursday,48712,9548,Festival,1,161,58.26,61894,48360,33.76,39748,5792,23858,0,38161.28571,10196.71429,58260,45540,23858,48358
6/23/2023,2,Agency_2,Friday,18325,7043,Festival,0,161,25.37,61894,48360,50.71,48712,9548,50198,3617,33608,10686.14286,25368,58260,53815,44294.14286
6/24/2023,2,Agency_2,Saturday,49505,14807,Sports Event,0,161,64.31,61894,48360,29.68,18325,7043,32736,6099,36003.57143,11930.14286,64312,25368,38835,47933.71429
6/25/2023,2,Agency_2,Sunday,21907,5591,None,0,161,27.5,61894,48360,49.93,49505,14807,31650,22651,34611.71429,9493,27498,64312,54301,44104.71429
6/26/2023,2,Agency_2,Monday,23908,12814,None,1,161,36.72,61894,48360,43.87,21907,5591,34438,13549,33107.42857,9388,36722,27498,47987,42495.42857
6/27/2023,2,Agency_2,Tuesday,28481,8204,None,1,161,36.69,61894,48360,44.82,23908,12814,29647,10121,32940.85714,9114.142857,36685,36722,39768,42055
6/28/2023,2,Agency_2,Wednesday,37726,9310,Concert,0,161,47.04,61894,48360,39.42,28481,8204,39748,5792,32652,9616.714286,47036,36685,45540,42268.71429
6/29/2023,2,Agency_2,Thursday,28056,7831,Festival,0,161,35.89,61894,48360,45.29,37726,9310,48712,9548,29701.14286,9371.428571,35887,47036,58260,39072.57143
6/30/2023,2,Agency_2,Friday,38299,11721,Sports Event,1,161,50.02,61894,48360,37.44,28056,7831,18325,7043,32554.57143,10039.71429,50020,35887,25368,42594.28571
7/1/2023,2,Agency_2,Saturday,42548,11277,Sports Event,0,161,53.83,61894,48360,35.63,38299,11721,49505,14807,31560.71429,9535.428571,53825,50020,64312,41096.14286
7/2/2023,2,Agency_2,Sunday,55371,14968,Festival,1,161,70.34,61894,48360,26.64,42548,11277,21907,5591,36341.28571,10875,70339,53825,27498,47216.28571
7/3/2023,2,Agency_2,Monday,30589,1705,Festival,0,161,32.29,61894,48360,48.31,55371,14968,23908,12814,37295.71429,9288,32294,70339,36722,46583.71429
7/4/2023,2,Agency_2,Tuesday,36871,9676,Concert,0,161,46.55,61894,48360,39.59,30589,1705,28481,8204,38494.28571,9498.285714,46547,32294,36685,47992.57143
7/5/2023,2,Agency_2,Wednesday,37485,0,Sports Event,0,161,37.48,61894,48360,46.06,36871,9676,37726,9310,38459.85714,8168.285714,37485,46547,47036,46628.14286
7/6/2023,2,Agency_2,Thursday,39573,6608,None,1,161,46.18,61894,48360,40.39,37485,0,28056,7831,40105.14286,7993.571429,46181,37485,35887,48098.71429
7/7/2023,2,Agency_2,Friday,38310,4964,Festival,0,161,43.27,61894,48360,42.17,39573,6608,38299,11721,40106.71429,7028.285714,43274,46181,50020,47135
7/8/2023,2,Agency_2,Saturday,41513,6393,Festival,0,161,47.91,61894,48360,39.57,38310,4964,42548,11277,39958.85714,6330.571429,47906,43274,53825,46289.42857
7/9/2023,2,Agency_2,Sunday,30385,19509,Sports Event,0,161,49.9,61894,48360,35.95,41513,6393,55371,14968,36389.42857,6979.285714,49894,47906,70339,43368.71429
7/10/2023,2,Agency_2,Monday,28569,9237,Festival,0,161,37.81,61894,48360,44.05,30385,19509,30589,1705,36100.85714,8055.285714,37806,49894,32294,44156.14286
7/11/2023,2,Agency_2,Tuesday,47482,14258,Concert,1,161,61.74,61894,48360,31.08,28569,9237,36871,9676,37616.71429,8709.857143,61740,37806,46547,46326.57143
7/12/2023,2,Agency_2,Wednesday,40466,13635,Festival,1,161,54.1,61894,48360,35.02,47482,14258,37485,0,38042.57143,10657.71429,54101,61740,37485,48700.28571
7/13/2023,2,Agency_2,Thursday,48025,8302,Festival,0,161,56.33,61894,48360,34.97,40466,13635,39573,6608,39250,10899.71429,56327,54101,46181,50149.71429
7/14/2023,2,Agency_2,Friday,31507,12071,Concert,0,161,43.58,61894,48360,40.6,48025,8302,38310,4964,38278.14286,11915,43578,56327,43274,50193.14286
7/15/2023,2,Agency_2,Saturday,45948,16296,Sports Event,0,161,62.25,61894,48360,30.42,31507,12071,41513,6393,38911.71429,13329.71429,62244,43578,47906,52241.42857
7/16/2023,2,Agency_2,Sunday,41747,5995,Concert,0,161,47.74,61894,48360,39.73,45948,16296,30385,19509,40534.85714,11399.14286,47742,62244,49894,51934
7/17/2023,2,Agency_2,Monday,28167,2707,None,0,161,30.87,61894,48360,48.82,41747,5995,28569,9237,40477.42857,10466.28571,30874,47742,37806,50943.71429
7/18/2023,2,Agency_2,Tuesday,41950,8308,Sports Event,1,161,50.26,61894,48360,38.01,28167,2707,47482,14258,39687.14286,9616.285714,50258,30874,61740,49303.42857
7/19/2023,2,Agency_2,Wednesday,38374,13463,Sports Event,1,161,51.84,61894,48360,36.19,41950,8308,40466,13635,39388.28571,9591.714286,51837,50258,54101,48980
7/20/2023,2,Agency_2,Thursday,42131,13906,Concert,1,161,56.04,61894,48360,34,38374,13463,48025,8302,38546.28571,10392.28571,56037,51837,56327,48938.57143
7/21/2023,2,Agency_2,Friday,54732,14058,Festival,1,161,68.79,61894,48360,27.59,42131,13906,31507,12071,41864.14286,10676.14286,68790,56037,43578,52540.28571
7/22/2023,2,Agency_2,Saturday,22534,9006,None,0,161,31.54,61894,48360,47.23,54732,14058,45948,16296,38519.28571,9634.714286,31540,68790,62244,48154
7/23/2023,2,Agency_2,Sunday,46704,5622,Concert,0,161,52.33,61894,48360,37.51,22534,9006,41747,5995,39227.42857,9581.428571,52326,31540,47742,48808.85714
7/24/2023,2,Agency_2,Monday,22987,6402,None,0,161,29.39,61894,48360,48.82,46704,5622,28167,2707,38487.42857,10109.28571,29389,52326,30874,48596.71429
7/25/2023,2,Agency_2,Tuesday,36098,18447,Festival,1,161,54.55,61894,48360,33.84,22987,6402,41950,8308,37651.42857,11557.71429,54545,29389,50258,49209.14286
7/26/2023,2,Agency_2,Wednesday,37535,12497,Sports Event,1,161,50.03,61894,48360,37.28,36098,18447,38374,13463,37531.57143,11419.71429,50032,54545,51837,48951.28571
7/27/2023,2,Agency_2,Thursday,37311,11973,Sports Event,1,161,49.29,61894,48360,37.76,37535,12497,42131,13906,36843,11143.57143,49284,50032,56037,47986.57143
7/28/2023,2,Agency_2,Friday,21777,3602,Festival,0,161,25.38,61894,48360,51.39,37311,11973,54732,14058,32135.14286,9649.857143,25379,49284,68790,41785
7/29/2023,2,Agency_2,Saturday,43636,6016,None,1,161,49.65,61894,48360,38.77,21777,3602,22534,9006,35149.71429,9222.714286,49652,25379,31540,44372.42857
7/30/2023,2,Agency_2,Sunday,27077,1531,Sports Event,0,161,28.61,61894,48360,50.19,43636,6016,46704,5622,32345.85714,8638.285714,28608,49652,52326,40984.14286
7/31/2023,2,Agency_2,Monday,32769,5600,Festival,1,161,38.37,61894,48360,44.49,27077,1531,22987,6402,33743.28571,8523.714286,38369,28608,29389,42267
8/1/2023,2,Agency_2,Tuesday,42315,11932,Festival,0,161,54.25,61894,48360,35.29,32769,5600,36098,18447,34631.42857,7593,54247,38369,54545,42224.42857
8/2/2023,2,Agency_2,Wednesday,32290,22619,Concert,1,161,54.91,61894,48360,32.82,42315,11932,37535,12497,33882.14286,9039,54909,54247,50032,42921.14286
8/3/2023,2,Agency_2,Thursday,24908,4350,None,0,161,29.26,61894,48360,49.3,32290,22619,37311,11973,32110.28571,7950,29258,54909,49284,40060.28571
8/4/2023,2,Agency_2,Friday,14628,22802,Concert,1,161,37.43,61894,48360,41.52,24908,4350,21777,3602,31089,10692.85714,37430,29258,25379,41781.85714
8/5/2023,2,Agency_2,Saturday,23493,3776,Concert,0,161,27.27,61894,48360,50.41,14628,22802,43636,6016,28211.42857,10372.85714,27269,37430,49652,38584.28571
8/6/2023,2,Agency_2,Sunday,58762,30565,Festival,1,161,89.33,61894,48360,14.02,23493,3776,27077,1531,32737.85714,14520.57143,89327,27269,28608,47258.42857
8/7/2023,2,Agency_2,Monday,40381,10415,Festival,0,161,50.8,61894,48360,37.32,58762,30565,32769,5600,33825.28571,15208.42857,50796,89327,38369,49033.71429
8/8/2023,2,Agency_2,Tuesday,29864,9388,None,1,161,39.25,61894,48360,43.29,40381,10415,42315,11932,32046.57143,14845,39252,50796,54247,46891.57143
8/9/2023,2,Agency_2,Wednesday,35691,9455,Sports Event,0,161,45.15,61894,48360,40.33,29864,9388,32290,22619,32532.42857,12964.42857,45146,39252,54909,45496.85714
8/10/2023,2,Agency_2,Thursday,40015,11600,Concert,1,161,51.62,61894,48360,36.67,35691,9455,24908,4350,34690.57143,14000.14286,51615,45146,29258,48690.71429
8/11/2023,2,Agency_2,Friday,31648,10562,Concert,1,161,42.21,61894,48360,41.58,40015,11600,14628,22802,37122,12251.57143,42210,51615,37430,49373.57143
8/12/2023,2,Agency_2,Saturday,17994,8741,None,1,161,26.74,61894,48360,49.68,31648,10562,23493,3776,36336.42857,12960.85714,26735,42210,27269,49297.28571
8/13/2023,2,Agency_2,Sunday,23488,5081,None,1,161,28.57,61894,48360,49.5,17994,8741,58762,30565,31297.28571,9320.285714,28569,26735,89327,40617.57143
8/14/2023,2,Agency_2,Monday,27168,10897,None,1,161,38.07,61894,48360,43.59,23488,5081,40381,10415,29409.71429,9389.142857,38065,28569,50796,38798.85714
8/15/2023,2,Agency_2,Tuesday,31968,2601,None,1,161,34.57,61894,48360,46.99,27168,10897,29864,9388,29710.28571,8419.571429,34569,38065,39252,38129.85714
8/16/2023,2,Agency_2,Wednesday,29349,16376,Sports Event,1,161,45.73,61894,48360,38.66,31968,2601,35691,9455,28804.28571,9408.285714,45725,34569,45146,38212.57143
8/17/2023,2,Agency_2,Thursday,29419,10829,Sports Event,1,161,40.25,61894,48360,42.51,29349,16376,40015,11600,27290.57143,9298.142857,40248,45725,51615,36588.71429
8/18/2023,2,Agency_2,Friday,29575,4288,None,1,161,33.86,61894,48360,47.01,29419,10829,31648,10562,26994.42857,8401.857143,33863,40248,42210,35396.28571
8/19/2023,2,Agency_2,Saturday,32020,4242,None,1,161,36.26,61894,48360,45.82,29575,4288,17994,8741,28998.14286,7759.142857,36262,33863,26735,36757.28571
8/20/2023,2,Agency_2,Sunday,39763,17447,Concert,1,161,57.21,61894,48360,32.7,32020,4242,23488,5081,31323.14286,9525.714286,57210,36262,28569,40848.85714
8/21/2023,2,Agency_2,Monday,18052,9996,Festival,0,161,28.05,61894,48360,48.78,39763,17447,27168,10897,30020.85714,9397,28048,57210,38065,39417.85714
8/22/2023,2,Agency_2,Tuesday,29851,10376,Sports Event,0,161,40.23,61894,48360,42.61,18052,9996,31968,2601,29718.42857,10507.71429,40227,28048,34569,40226.14286
8/23/2023,2,Agency_2,Wednesday,41182,18392,Concert,1,161,59.57,61894,48360,31.33,29851,10376,29349,16376,31408.85714,10795.71429,59574,40227,45725,42204.57143
8/24/2023,2,Agency_2,Thursday,30939,7039,Sports Event,0,161,37.98,61894,48360,44.4,41182,18392,29419,10829,31626,10254.28571,37978,59574,40248,41880.28571
8/25/2023,2,Agency_2,Friday,40191,14484,Sports Event,1,161,54.68,61894,48360,34.56,30939,7039,29575,4288,33142.57143,11710.85714,54675,37978,33863,44853.42857
8/26/2023,2,Agency_2,Saturday,36439,11229,Festival,0,161,47.67,61894,48360,38.72,40191,14484,32020,4242,33773.85714,12709,47668,54675,36262,46482.85714
8/27/2023,2,Agency_2,Sunday,29682,8119,Festival,0,161,37.8,61894,48360,44.27,36439,11229,39763,17447,32333.71429,11376.42857,37801,47668,57210,43710.14286
8/28/2023,2,Agency_2,Monday,12986,8499,None,0,161,21.48,61894,48360,52.36,29682,8119,18052,9996,31610,11162.57143,21485,37801,28048,42772.57143
8/29/2023,2,Agency_2,Tuesday,26871,8601,Concert,1,161,35.47,61894,48360,45.34,12986,8499,29851,10376,31184.28571,10909,35472,21485,40227,42093.28571
8/30/2023,2,Agency_2,Wednesday,24610,11541,Festival,0,161,36.15,61894,48360,44.41,26871,8601,41182,18392,28816.85714,9930.285714,36151,35472,59574,38747.14286
8/31/2023,2,Agency_2,Thursday,27787,12741,Concert,0,161,40.53,61894,48360,41.99,24610,11541,30939,7039,28366.57143,10744.85714,40528,36151,37978,39111.42857
9/1/2023,2,Agency_2,Friday,32432,13225,Concert,1,161,45.66,61894,48360,39.32,27787,12741,40191,14484,27258.14286,10565,45657,40528,54675,37823.14286
9/2/2023,2,Agency_2,Saturday,28481,20530,Concert,0,161,49.01,61894,48360,36.19,32432,13225,36439,11229,26121.28571,11893.71429,49011,45657,47668,38015
9/3/2023,2,Agency_2,Sunday,25311,12417,Concert,0,161,37.73,61894,48360,43.45,28481,20530,29682,8119,25496.85714,12507.71429,37728,49011,37801,38004.57143
9/4/2023,2,Agency_2,Monday,45177,13868,Concert,1,161,59.05,61894,48360,32.5,25311,12417,12986,8499,30095.57143,13274.71429,59045,37728,21485,43370.28571
9/5/2023,2,Agency_2,Tuesday,37192,11281,Sports Event,1,161,48.47,61894,48360,38.31,45177,13868,26871,8601,31570,13657.57143,48473,59045,35472,45227.57143
9/6/2023,2,Agency_2,Wednesday,39427,11197,Festival,1,161,50.62,61894,48360,37.25,37192,11281,24610,11541,33686.71429,13608.42857,50624,48473,36151,47295.14286
9/7/2023,2,Agency_2,Thursday,48397,22421,Concert,1,161,70.82,61894,48360,24.91,39427,11197,27787,12741,36631,14991.28571,70818,50624,40528,51622.28571
9/8/2023,2,Agency_2,Friday,22375,3164,None,1,161,25.54,61894,48360,51.4,48397,22421,32432,13225,35194.28571,13554,25539,70818,45657,48748.28571
9/9/2023,2,Agency_2,Saturday,45765,31431,Sports Event,1,161,77.2,61894,48360,19.91,22375,3164,28481,20530,37663.42857,15111.28571,77196,25539,49011,52774.71429
9/10/2023,2,Agency_2,Sunday,28765,18294,Festival,0,161,47.06,61894,48360,37.61,45765,31431,25311,12417,38156.85714,15950.85714,47059,77196,37728,54107.71429
9/11/2023,2,Agency_2,Monday,42582,6616,Festival,0,161,49.2,61894,48360,38.88,28765,18294,45177,13868,37786.14286,14914.85714,49198,47059,59045,52701
9/12/2023,2,Agency_2,Tuesday,44545,19649,Festival,1,161,64.2,61894,48360,28.77,42582,6616,37192,11281,38836.57143,16110.28571,64194,49198,48473,54946.85714
9/13/2023,2,Agency_2,Wednesday,27156,7806,Sports Event,0,161,34.96,61894,48360,45.76,44545,19649,39427,11197,37083.57143,15625.85714,34962,64194,50624,52709.42857
9/14/2023,2,Agency_2,Thursday,22218,4158,None,1,161,26.38,61894,48360,50.78,27156,7806,48397,22421,33343.71429,13016.85714,26376,34962,70818,46360.57143
9/15/2023,2,Agency_2,Friday,25129,4338,Festival,0,161,29.47,61894,48360,49.2,22218,4158,22375,3164,33737.14286,13184.57143,29467,26376,25539,46921.71429
9/16/2023,2,Agency_2,Saturday,31465,6297,None,1,161,37.76,61894,48360,44.66,25129,4338,45765,31431,31694.28571,9594,37762,29467,77196,41288.28571
9/17/2023,2,Agency_2,Sunday,38102,4172,Sports Event,0,161,42.27,61894,48360,42.83,31465,6297,28765,18294,33028.14286,7576.571429,42274,37762,47059,40604.71429
9/18/2023,2,Agency_2,Monday,32481,11333,Sports Event,0,161,43.81,61894,48360,40.62,38102,4172,42582,6616,31585.14286,8250.428571,43814,42274,49198,39835.57143
9/19/2023,2,Agency_2,Tuesday,19560,13680,Festival,1,161,33.24,61894,48360,45.44,32481,11333,44545,19649,28015.85714,7397.714286,33240,43814,64194,35413.57143
9/20/2023,2,Agency_2,Wednesday,39207,4386,Concert,0,161,43.59,61894,48360,42.13,19560,13680,27156,7806,29737.42857,6909.142857,43593,33240,34962,36646.57143
9/21/2023,2,Agency_2,Thursday,42543,9924,Sports Event,0,161,52.47,61894,48360,36.58,39207,4386,22218,4158,32641,7732.857143,52467,43593,26376,40373.85714
9/22/2023,2,Agency_2,Friday,24711,8309,Festival,0,161,33.02,61894,48360,46.63,42543,9924,25129,4338,32581.28571,8300.142857,33020,52467,29467,40881.42857
9/23/2023,2,Agency_2,Saturday,41023,11385,Concert,0,161,52.41,61894,48360,36.32,24711,8309,31465,6297,33946.71429,9027,52408,33020,37762,42973.71429
9/24/2023,2,Agency_2,Sunday,53101,9770,Concert,1,161,62.87,61894,48360,31.41,41023,11385,38102,4172,36089.42857,9826.714286,62871,52408,42274,45916.14286
9/25/2023,2,Agency_2,Monday,31269,3692,Sports Event,0,161,34.96,61894,48360,46.58,53101,9770,32481,11333,35916.28571,8735.142857,34961,62871,43814,44651.42857
9/26/2023,2,Agency_2,Tuesday,37913,7596,Festival,1,161,45.51,61894,48360,40.52,31269,3692,19560,13680,38538.14286,7866,45509,34961,33240,46404.14286
9/27/2023,2,Agency_2,Wednesday,31827,17783,Festival,1,161,49.61,61894,48360,36.44,37913,7596,39207,4386,37483.85714,9779.857143,49610,45509,43593,47263.71429
9/28/2023,2,Agency_2,Thursday,49639,14798,Sports Event,1,161,64.44,61894,48360,29.62,31827,17783,42543,9924,38497.57143,10476.14286,64437,49610,52467,48973.71429
9/29/2023,2,Agency_2,Friday,18899,6113,None,1,161,25.01,61894,48360,51.07,49639,14798,24711,8309,37667.28571,10162.42857,25012,64437,33020,47829.71429
9/30/2023,2,Agency_2,Saturday,40661,9615,None,1,161,50.28,61894,48360,37.74,18899,6113,41023,11385,37615.57143,9909.571429,50276,25012,52408,47525.14286
10/1/2023,2,Agency_2,Sunday,49289,10530,None,1,161,59.82,61894,48360,32.78,40661,9615,53101,9770,37071,10018.14286,59819,50276,62871,47089.14286
10/2/2023,2,Agency_2,Monday,40872,10426,Festival,1,161,51.3,61894,48360,37.06,49289,10530,31269,3692,38442.85714,10980.14286,51298,59819,34961,49423
10/3/2023,2,Agency_2,Tuesday,40300,11174,Concert,1,161,51.47,61894,48360,36.83,40872,10426,37913,7596,38783.85714,11491.28571,51474,51298,45509,50275.14286
10/4/2023,2,Agency_2,Wednesday,23540,6913,None,0,161,30.45,61894,48360,48.19,40300,11174,31827,17783,37600,9938.428571,30453,51474,49610,47538.42857
10/5/2023,2,Agency_2,Thursday,31336,5562,Festival,1,161,36.9,61894,48360,45.24,23540,6913,49639,14798,34985.28571,8619,36898,30453,64437,43604.28571
10/6/2023,2,Agency_2,Friday,16227,10225,Sports Event,0,161,26.45,61894,48360,49.53,31336,5562,18899,6113,34603.57143,9206.428571,26452,36898,25012,43810
10/7/2023,2,Agency_2,Saturday,22593,1263,None,1,161,23.86,61894,48360,52.62,16227,10225,40661,9615,32022.42857,8013.285714,23856,26452,50276,40035.71429
10/8/2023,2,Agency_2,Sunday,51344,30893,Sports Event,1,161,82.24,61894,48360,17.5,22593,1263,49289,10530,32316,10922.28571,82237,23856,59819,43238.28571
10/9/2023,2,Agency_2,Monday,29953,11349,Concert,0,161,41.3,61894,48360,41.88,51344,30893,40872,10426,30756.14286,11054.14286,41302,82237,51298,41810.28571
10/10/2023,2,Agency_2,Tuesday,39797,11428,Sports Event,1,161,51.23,61894,48360,36.9,29953,11349,40300,11174,30684.28571,11090.42857,51225,41302,51474,41774.71429
10/11/2023,2,Agency_2,Wednesday,31973,6186,None,1,161,38.16,61894,48360,44.48,39797,11428,23540,6913,31889,10986.57143,38159,51225,30453,42875.57143
10/12/2023,2,Agency_2,Thursday,32004,9593,Festival,0,161,41.6,61894,48360,42.08,31973,6186,31336,5562,31984.42857,11562.42857,41597,38159,36898,43546.85714
10/13/2023,2,Agency_2,Friday,32485,16621,Concert,1,161,49.11,61894,48360,36.92,32004,9593,16227,10225,34307,12476.14286,49106,41597,26452,46783.14286
10/14/2023,2,Agency_2,Saturday,34425,7708,Sports Event,0,161,42.13,61894,48360,42.19,32485,16621,22593,1263,35997.28571,13396.85714,42133,49106,23856,49394.14286
10/15/2023,2,Agency_2,Sunday,40827,7078,Concert,0,161,47.91,61894,48360,39.43,34425,7708,51344,30893,34494.85714,9994.714286,47905,42133,82237,44489.57143
10/16/2023,2,Agency_2,Monday,30210,8467,Concert,0,161,38.68,61894,48360,43.77,40827,7078,29953,11349,34531.57143,9583,38677,47905,41302,44114.57143
10/17/2023,2,Agency_2,Tuesday,38143,10113,Festival,0,161,48.26,61894,48360,38.65,30210,8467,39797,11428,34295.28571,9395.142857,48256,38677,51225,43690.42857
10/18/2023,2,Agency_2,Wednesday,25836,9289,None,1,161,35.13,61894,48360,45.38,38143,10113,31973,6186,33418.57143,9838.428571,35125,48256,38159,43257
10/19/2023,2,Agency_2,Thursday,52554,14553,Concert,1,161,67.11,61894,48360,28.33,25836,9289,32004,9593,36354.28571,10547,67107,35125,41597,46901.28571
10/20/2023,2,Agency_2,Friday,30076,4039,Concert,0,161,34.12,61894,48360,46.93,52554,14553,32485,16621,36010.14286,8749.571429,34115,67107,49106,44759.71429
10/21/2023,2,Agency_2,Saturday,26413,9699,Concert,0,161,36.11,61894,48360,44.8,30076,4039,34425,7708,34865.57143,9034,36112,34115,42133,43899.57143
10/22/2023,2,Agency_2,Sunday,30513,10223,Sports Event,0,161,40.74,61894,48360,42.39,26413,9699,40827,7078,33392.14286,9483.285714,40736,36112,47905,42875.42857
10/23/2023,2,Agency_2,Monday,39551,14420,Sports Event,1,161,53.97,61894,48360,34.93,30513,10223,30210,8467,34726.57143,10333.71429,53971,40736,38677,45060.28571
10/24/2023,2,Agency_2,Tuesday,38311,14215,Concert,1,161,52.53,61894,48360,35.69,39551,14420,38143,10113,34750.57143,10919.71429,52526,53971,48256,45670.28571
10/25/2023,2,Agency_2,Wednesday,39627,2496,Festival,1,161,42.12,61894,48360,43.24,38311,14215,25836,9289,36720.71429,9949.285714,42123,52526,35125,46670
10/26/2023,2,Agency_2,Thursday,22954,8008,Concert,0,161,30.96,61894,48360,47.72,39627,2496,52554,14553,32492.14286,9014.285714,30962,42123,67107,41506.42857
10/27/2023,2,Agency_2,Friday,27204,14753,Festival,1,161,41.96,61894,48360,40.87,22954,8008,30076,4039,32081.85714,10544.85714,41957,30962,34115,42626.71429
10/28/2023,2,Agency_2,Saturday,64708,23010,Concert,1,161,87.72,61894,48360,16.34,27204,14753,26413,9699,37552.57143,12446.42857,87718,41957,36112,49999
10/29/2023,2,Agency_2,Sunday,44300,24693,Sports Event,1,161,68.99,61894,48360,25.36,64708,23010,30513,10223,39522.14286,14513.57143,68993,87718,40736,54035.71429
10/30/2023,2,Agency_2,Monday,40448,10293,Festival,1,161,50.74,61894,48360,37.37,44300,24693,39551,14420,39650.28571,13924,50741,68993,53971,53574.28571
10/31/2023,2,Agency_2,Tuesday,25398,7471,Sports Event,0,161,32.87,61894,48360,46.87,40448,10293,38311,14215,37805.57143,12960.57143,32869,50741,52526,50766.14286
11/1/2023,2,Agency_2,Wednesday,27088,9078,Concert,0,161,36.17,61894,48360,44.9,25398,7471,39627,2496,36014.28571,13900.85714,36166,32869,42123,49915.14286
11/2/2023,2,Agency_2,Thursday,31203,8510,Festival,0,161,39.71,61894,48360,43.24,27088,9078,22954,8008,37192.71429,13972.57143,39713,36166,30962,51165.28571
11/3/2023,2,Agency_2,Friday,43258,17566,Sports Event,1,161,60.83,61894,48360,30.87,31203,8510,27204,14753,39486.14286,14374.42857,60824,39713,41957,53860.57143
11/4/2023,2,Agency_2,Saturday,29696,2639,None,0,161,32.34,61894,48360,48.1,43258,17566,64708,23010,34484.42857,11464.28571,32335,60824,87718,45948.71429
11/5/2023,2,Agency_2,Sunday,13014,15178,Festival,0,161,28.19,61894,48360,47.67,29696,2639,44300,24693,30015,10105,28192,32335,68993,40120
11/6/2023,2,Agency_2,Monday,25671,10829,Concert,1,161,36.5,61894,48360,44.38,13014,15178,40448,10293,27904,10181.57143,36500,28192,50741,38085.57143
11/7/2023,2,Agency_2,Tuesday,21223,2373,Sports Event,0,161,23.6,61894,48360,52.53,25671,10829,25398,7471,27307.57143,9453.285714,23596,36500,32869,36760.85714
11/8/2023,2,Agency_2,Wednesday,34060,11080,Sports Event,0,161,45.14,61894,48360,40.01,21223,2373,27088,9078,28303.57143,9739.285714,45140,23596,36166,38042.85714
11/9/2023,2,Agency_2,Thursday,33378,0,Concert,1,161,33.38,61894,48360,48.11,34060,11080,31203,8510,28614.28571,8523.571429,33378,45140,39713,37137.85714
11/10/2023,2,Agency_2,Friday,25902,9831,Festival,0,161,35.73,61894,48360,44.97,33378,0,43258,17566,26134.85714,7418.571429,35733,33378,60824,33553.42857
11/11/2023,2,Agency_2,Saturday,22689,11858,Sports Event,0,161,34.55,61894,48360,45.15,25902,9831,29696,2639,25133.85714,8735.571429,34547,35733,32335,33869.42857
11/12/2023,2,Agency_2,Sunday,46619,19052,Sports Event,1,161,65.67,61894,48360,28.15,22689,11858,13014,15178,29934.57143,9289,65671,34547,28192,39223.57143
11/13/2023,2,Agency_2,Monday,40164,7266,Concert,1,161,47.43,61894,48360,39.63,46619,19052,25671,10829,32005,8780,47430,65671,36500,40785
11/14/2023,2,Agency_2,Tuesday,33776,6554,None,1,161,40.33,61894,48360,43.32,40164,7266,21223,2373,33798.28571,9377.285714,40330,47430,23596,43175.57143
11/15/2023,2,Agency_2,Wednesday,29794,5326,Concert,0,161,35.12,61894,48360,46.17,33776,6554,34060,11080,33188.85714,8555.285714,35120,40330,45140,41744.14286
11/16/2023,2,Agency_2,Thursday,26674,5491,Festival,0,161,32.17,61894,48360,47.62,29794,5326,33378,0,32231.14286,9339.714286,32165,35120,33378,41570.85714
11/17/2023,2,Agency_2,Friday,28702,14319,Festival,0,161,43.02,61894,48360,40.42,26674,5491,25902,9831,32631.14286,9980.857143,43021,32165,35733,42612
11/18/2023,2,Agency_2,Saturday,23652,3916,Concert,0,161,27.57,61894,48360,50.23,28702,14319,22689,11858,32768.71429,8846.285714,27568,43021,34547,41615
11/19/2023,2,Agency_2,Sunday,64010,14173,Festival,1,161,78.18,61894,48360,22.87,23652,3916,46619,19052,35253.14286,8149.285714,78183,27568,65671,43402.42857
11/20/2023,2,Agency_2,Monday,32475,16848,Concert,1,161,49.32,61894,48360,36.77,64010,14173,40164,7266,34154.71429,9518.142857,49323,78183,47430,43672.85714
11/21/2023,2,Agency_2,Tuesday,25456,14708,Sports Event,0,161,40.16,61894,48360,41.77,32475,16848,33776,6554,32966.14286,10683,40164,49323,40330,43649.14286
11/22/2023,2,Agency_2,Wednesday,23389,4024,None,0,161,27.41,61894,48360,50.29,25456,14708,29794,5326,32051.14286,10497,27413,40164,35120,42548.14286
11/23/2023,2,Agency_2,Thursday,46179,6439,Festival,0,161,52.62,61894,48360,37.2,23389,4024,26674,5491,34837.57143,10632.42857,52618,27413,32165,45470
11/24/2023,2,Agency_2,Friday,46234,13323,Concert,1,161,59.56,61894,48360,32.36,46179,6439,28702,14319,37342.14286,10490.14286,59557,52618,43021,47832.28571
11/25/2023,2,Agency_2,Saturday,41352,14783,None,1,161,56.14,61894,48360,33.77,46234,13323,23652,3916,39870.71429,12042.57143,56135,59557,27568,51913.28571
11/26/2023,2,Agency_2,Sunday,47174,10807,Concert,1,161,57.98,61894,48360,33.65,41352,14783,64010,14173,37465.57143,11561.71429,57981,56135,78183,49027.28571
11/27/2023,2,Agency_2,Monday,22299,3644,None,0,161,25.94,61894,48360,51.1,47174,10807,32475,16848,36011.85714,9675.428571,25943,57981,49323,45687.28571
11/28/2023,2,Agency_2,Tuesday,58628,12549,Concert,1,161,71.18,61894,48360,26.7,22299,3644,25456,14708,40750.71429,9367,71177,25943,40164,50117.71429
11/29/2023,2,Agency_2,Wednesday,27259,9127,Sports Event,0,161,36.39,61894,48360,44.78,58628,12549,23389,4024,41303.57143,10096,36386,71177,27413,51399.57143
11/30/2023,2,Agency_2,Thursday,17243,4278,None,1,161,21.52,61894,48360,53.18,27259,9127,46179,6439,37169.85714,9787.285714,21521,36386,52618,46957.14286
12/1/2023,2,Agency_2,Friday,26002,3686,None,0,161,29.69,61894,48360,49.22,17243,4278,46234,13323,34279.57143,8410.571429,29688,21521,59557,42690.14286
12/2/2023,2,Agency_2,Saturday,34550,18789,Concert,1,161,53.34,61894,48360,34.37,26002,3686,41352,14783,33307.85714,8982.857143,53339,29688,56135,42290.71429
12/3/2023,2,Agency_2,Sunday,46670,14225,Sports Event,0,161,60.9,61894,48360,31.51,34550,18789,47174,10807,33235.85714,9471.142857,60895,53339,57981,42707
12/4/2023,2,Agency_2,Monday,37470,5926,Festival,0,161,43.4,61894,48360,41.92,46670,14225,22299,3644,35403.14286,9797.142857,43396,60895,25943,45200.28571
12/5/2023,2,Agency_2,Tuesday,19335,13603,Sports Event,0,161,32.94,61894,48360,45.61,37470,5926,58628,12549,29789.85714,9947.714286,32938,43396,71177,39737.57143
12/6/2023,2,Agency_2,Wednesday,23901,6297,None,1,161,30.2,61894,48360,48.44,19335,13603,27259,9127,29310.14286,9543.428571,30198,32938,36386,38853.57143
12/7/2023,2,Agency_2,Thursday,26640,6112,None,0,161,32.75,61894,48360,47.2,23901,6297,17243,4278,30652.57143,9805.428571,32752,30198,21521,40458
12/8/2023,2,Agency_2,Friday,43444,22205,Sports Event,1,161,65.65,61894,48360,27.53,26640,6112,26002,3686,33144.28571,12451,65649,32752,29688,45595.28571
12/9/2023,2,Agency_2,Saturday,26179,12476,None,1,161,38.66,61894,48360,42.98,43444,22205,34550,18789,31948.42857,11549.14286,38655,65649,53339,43497.57143
12/10/2023,2,Agency_2,Sunday,47466,17131,Festival,1,161,64.6,61894,48360,29.07,26179,12476,46670,14225,32062.14286,11964.28571,64597,38655,60895,44026.42857
12/11/2023,2,Agency_2,Monday,35934,8421,None,1,161,44.36,61894,48360,40.94,47466,17131,37470,5926,31842.71429,12320.71429,44355,64597,43396,44163.42857
12/12/2023,2,Agency_2,Tuesday,29498,10003,None,1,161,39.5,61894,48360,43.05,35934,8421,19335,13603,33294.57143,11806.42857,39501,44355,32938,45101
12/13/2023,2,Agency_2,Wednesday,27262,5645,Concert,0,161,32.91,61894,48360,47.22,29498,10003,23901,6297,33774.71429,11713.28571,32907,39501,30198,45488
12/14/2023,2,Agency_2,Thursday,22162,1813,Festival,0,161,23.98,61894,48360,52.45,27262,5645,26640,6112,33135,11099.14286,23975,32907,32752,44234.14286
12/15/2023,2,Agency_2,Friday,39365,3910,None,1,161,43.28,61894,48360,42.38,22162,1813,43444,22205,32552.28571,8485.571429,43275,23975,65649,41037.85714
12/16/2023,2,Agency_2,Saturday,34007,9825,Festival,0,161,43.83,61894,48360,40.92,39365,3910,26179,12476,33670.57143,8106.857143,43832,43275,38655,41777.42857
12/17/2023,2,Agency_2,Sunday,50396,20516,Sports Event,1,161,70.91,61894,48360,25.24,34007,9825,47466,17131,34089.14286,8590.428571,70912,43832,64597,42679.57143
12/18/2023,2,Agency_2,Monday,36453,6516,Concert,0,161,42.97,61894,48360,42.01,50396,20516,35934,8421,34163.28571,8318.285714,42969,70912,44355,42481.57143
12/19/2023,2,Agency_2,Tuesday,24913,7790,None,1,161,32.7,61894,48360,46.89,36453,6516,29498,10003,33508.28571,8002.142857,32703,42969,39501,41510.42857
12/20/2023,2,Agency_2,Wednesday,24382,11499,None,1,161,35.88,61894,48360,44.56,24913,7790,27262,5645,33096.85714,8838.428571,35881,32703,32907,41935.28571
12/21/2023,2,Agency_2,Thursday,33681,10997,Concert,0,161,44.68,61894,48360,40.26,24382,11499,22162,1813,34742.42857,10150.42857,44678,35881,23975,44892.85714
12/22/2023,2,Agency_2,Friday,34971,12488,Concert,0,161,47.46,61894,48360,38.57,33681,10997,39365,3910,34114.71429,11375.85714,47459,44678,43275,45490.57143
12/23/2023,2,Agency_2,Saturday,48917,7444,Festival,1,161,56.36,61894,48360,35.13,34971,12488,34007,9825,36244.71429,11035.71429,56361,47459,43832,47280.42857
12/24/2023,2,Agency_2,Sunday,51475,11438,Sports Event,1,161,62.91,61894,48360,31.05,48917,7444,50396,20516,36398.85714,9738.857143,62913,56361,70912,46137.71429
12/25/2023,2,Agency_2,Monday,26034,10492,Festival,0,161,36.53,61894,48360,44.44,51475,11438,36453,6516,34910.42857,10306.85714,36526,62913,42969,45217.28571
12/26/2023,2,Agency_2,Tuesday,51072,11999,Concert,1,161,63.07,61894,48360,30.86,26034,10492,24913,7790,38647.42857,10908.14286,63071,36526,32703,49555.57143
12/27/2023,2,Agency_2,Wednesday,32316,14286,Festival,0,161,46.6,61894,48360,38.64,51072,11999,24382,11499,39780.85714,11306.28571,46602,63071,35881,51087.14286
12/28/2023,2,Agency_2,Thursday,41345,24283,Festival,1,161,65.63,61894,48360,27.13,32316,14286,33681,10997,40875.71429,13204.28571,65628,46602,44678,54080
12/29/2023,2,Agency_2,Friday,29675,2069,None,1,161,31.74,61894,48360,48.51,41345,24283,34971,12488,40119.14286,11715.85714,31744,65628,47459,51835
12/30/2023,2,Agency_2,Saturday,55612,17827,Sports Event,1,161,73.44,61894,48360,24.51,29675,2069,48917,7444,41075.57143,13199.14286,73439,31744,56361,54274.71429
12/31/2023,2,Agency_2,Sunday,61888,19634,Sports Event,1,161,81.52,61894,48360,20.11,55612,17827,51475,11438,42563.14286,14370,81522,73439,62913,56933.14286
1/8/2023,3,Agency_3,Sunday,37615,19479,Festival,1,177,57.1,72219,22243,19.24,45229,15559,45178,7892,33252.14286,11254.28571,57094,60788,53070,44506.42857
1/9/2023,3,Agency_3,Monday,29092,9926,Sports Event,0,177,39.02,72219,22243,30.18,37615,19479,28431,5606,33346.57143,11871.42857,39018,57094,34037,45218
1/10/2023,3,Agency_3,Tuesday,30345,9817,Sports Event,1,177,40.16,72219,22243,29.63,29092,9926,25645,10500,34018,11773.85714,40162,39018,36145,45791.85714
1/11/2023,3,Agency_3,Wednesday,35416,7231,Sports Event,0,177,42.65,72219,22243,28.91,30345,9817,42523,9841,33002.71429,11401,42647,40162,52364,44403.71429
1/12/2023,3,Agency_3,Thursday,55836,9996,Festival,1,177,65.83,72219,22243,16.76,35416,7231,27339,14015,37073.71429,10826.85714,65832,42647,41354,47900.57143
1/13/2023,3,Agency_3,Friday,31684,11670,Festival,0,177,43.36,72219,22243,27.67,55836,9996,25983,3780,37888.14286,11954,43354,65832,29763,49842.14286
1/14/2023,3,Agency_3,Saturday,20136,2689,None,1,177,22.83,72219,22243,39.73,31684,11670,45229,15559,34303.42857,10115.42857,22825,43354,60788,44418.85714
1/15/2023,3,Agency_3,Sunday,22267,16630,Festival,0,177,38.9,72219,22243,28.9,20136,2689,37615,19479,32110.85714,9708.428571,38897,22825,57094,41819.28571
1/16/2023,3,Agency_3,Monday,17240,10116,None,0,177,27.36,72219,22243,35.98,22267,16630,29092,9926,30417.71429,9735.571429,27356,38897,39018,40153.28571
1/17/2023,3,Agency_3,Tuesday,25767,9127,Sports Event,0,177,34.89,72219,22243,32.41,17240,10116,30345,9817,29763.71429,9637,34894,27356,40162,39400.71429
1/18/2023,3,Agency_3,Wednesday,41565,15320,Concert,0,177,56.89,72219,22243,20.17,25767,9127,35416,7231,30642.14286,10792.57143,56885,34894,42647,41434.71429
1/19/2023,3,Agency_3,Thursday,59098,17650,Concert,1,177,76.75,72219,22243,9.78,41565,15320,55836,9996,31108.14286,11886,76748,56885,65832,42994.14286
1/20/2023,3,Agency_3,Friday,48984,14720,Festival,1,177,63.7,72219,22243,16.88,59098,17650,31684,11670,33579.57143,12321.71429,63704,76748,43354,45901.28571
1/21/2023,3,Agency_3,Saturday,28669,5066,None,0,177,33.74,72219,22243,33.8,48984,14720,20136,2689,34798.57143,12661.28571,33735,63704,22825,47459.85714
1/22/2023,3,Agency_3,Sunday,37227,15448,Sports Event,1,177,52.68,72219,22243,22.25,28669,5066,22267,16630,36935.71429,12492.42857,52675,33735,38897,49428.14286
1/23/2023,3,Agency_3,Monday,37340,9741,Festival,1,177,47.08,72219,22243,26.19,37227,15448,17240,10116,39807.14286,12438.85714,47081,52675,27356,52246
1/24/2023,3,Agency_3,Tuesday,23481,6910,None,0,177,30.39,72219,22243,35.1,37340,9741,25767,9127,39480.57143,12122.14286,30391,47081,34894,51602.71429
1/25/2023,3,Agency_3,Wednesday,39861,18932,Festival,1,177,58.79,72219,22243,18.5,23481,6910,41565,15320,39237.14286,12638.14286,58793,30391,56885,51875.28571
1/26/2023,3,Agency_3,Thursday,27867,10976,Festival,1,177,38.84,72219,22243,30.06,39861,18932,59098,17650,34775.57143,11684.71429,38843,58793,76748,46460.28571
1/27/2023,3,Agency_3,Friday,24622,2152,Concert,0,177,26.77,72219,22243,37.86,27867,10976,48984,14720,31295.28571,9889.285714,26774,38843,63704,41184.57143
1/28/2023,3,Agency_3,Saturday,23503,6182,None,0,177,29.69,72219,22243,35.6,24622,2152,28669,5066,30557.28571,10048.71429,29685,26774,33735,40606
1/29/2023,3,Agency_3,Sunday,64506,19371,Sports Event,1,177,83.88,72219,22243,5.87,23503,6182,37227,15448,34454.28571,10609.14286,83877,29685,52675,45063.42857
1/30/2023,3,Agency_3,Monday,19342,12191,None,1,177,31.53,72219,22243,33.47,64506,19371,37340,9741,31883.14286,10959.14286,31533,83877,47081,42842.28571
1/31/2023,3,Agency_3,Tuesday,50904,14670,Festival,1,177,65.58,72219,22243,15.96,19342,12191,23481,6910,35800.71429,12067.71429,65574,31533,30391,47868.42857
2/1/2023,3,Agency_3,Wednesday,36790,7332,Concert,1,177,44.12,72219,22243,28.15,50904,14670,39861,18932,35362,10410.57143,44122,65574,58793,45772.57143
2/2/2023,3,Agency_3,Thursday,27207,12200,Sports Event,0,177,39.41,72219,22243,29.54,36790,7332,27867,10976,35267.71429,10585.42857,39407,44122,38843,45853.14286
2/3/2023,3,Agency_3,Friday,29422,8086,None,0,177,37.51,72219,22243,31.31,27207,12200,24622,2152,35953.42857,11433.14286,37508,39407,26774,47386.57143
2/4/2023,3,Agency_3,Saturday,27385,5023,None,1,177,32.41,72219,22243,34.47,29422,8086,23503,6182,36508,11267.57143,32408,37508,29685,47775.57143
2/5/2023,3,Agency_3,Sunday,48447,4526,Concert,1,177,52.97,72219,22243,24.29,27385,5023,64506,19371,34213.85714,9146.857143,52973,32408,83877,43360.71429
2/6/2023,3,Agency_3,Monday,28099,6585,None,1,177,34.69,72219,22243,33.02,48447,4526,19342,12191,35464.85714,8346,34684,52973,31533,43810.85714
2/7/2023,3,Agency_3,Tuesday,26503,3077,Festival,0,177,29.58,72219,22243,36.27,28099,6585,50904,14670,31979,6689.857143,29580,34684,65574,38668.85714
2/8/2023,3,Agency_3,Wednesday,44007,9362,Festival,1,177,53.37,72219,22243,23.12,26503,3077,36790,7332,33010,6979.857143,53369,29580,44122,39989.85714
2/9/2023,3,Agency_3,Thursday,21225,0,Concert,0,177,21.23,72219,22243,41.07,44007,9362,27207,12200,32155.42857,5237,21225,53369,39407,37392.42857
2/10/2023,3,Agency_3,Friday,29793,14524,Festival,0,177,44.32,72219,22243,26.62,21225,0,29422,8086,32208.42857,6156.714286,44317,21225,37508,38365.14286
2/11/2023,3,Agency_3,Saturday,33967,5310,None,0,177,39.28,72219,22243,30.98,29793,14524,27385,5023,33148.71429,6197.714286,39277,44317,32408,39346.42857
2/12/2023,3,Agency_3,Sunday,30578,13120,Concert,0,177,43.7,72219,22243,27.21,33967,5310,48447,4526,30596,7425.428571,43698,39277,52973,38021.42857
2/13/2023,3,Agency_3,Monday,22512,9525,Sports Event,0,177,32.04,72219,22243,33.76,30578,13120,28099,6585,29797.85714,7845.428571,32037,43698,34684,37643.28571
2/14/2023,3,Agency_3,Tuesday,46468,17738,Festival,1,177,64.21,72219,22243,16.03,22512,9525,26503,3077,32650,9939.857143,64206,32037,29580,42589.85714
2/15/2023,3,Agency_3,Wednesday,29248,7806,Sports Event,0,177,37.05,72219,22243,31.59,46468,17738,44007,9362,30541.57143,9717.571429,37054,64206,53369,40259.14286
2/16/2023,3,Agency_3,Thursday,15610,3346,None,0,177,18.96,72219,22243,41.53,29248,7806,21225,0,29739.42857,10195.57143,18956,37054,21225,39935
2/17/2023,3,Agency_3,Friday,36790,13646,Festival,1,177,50.44,72219,22243,23.73,15610,3346,29793,14524,30739,10070.14286,50436,18956,44317,40809.14286
2/18/2023,3,Agency_3,Saturday,57486,10497,Sports Event,1,177,67.98,72219,22243,15.59,36790,13646,33967,5310,34098.85714,10811.14286,67983,50436,39277,44910
2/19/2023,3,Agency_3,Sunday,49433,9849,Sports Event,0,177,59.28,72219,22243,20.07,57486,10497,30578,13120,36792.42857,10343.85714,59282,67983,43698,47136.28571
2/20/2023,3,Agency_3,Monday,38791,8341,Concert,1,177,47.13,72219,22243,26.44,49433,9849,22512,9525,39118,10174.71429,47132,59282,32037,49292.71429
2/21/2023,3,Agency_3,Tuesday,10241,9475,None,1,177,19.72,72219,22243,39.93,38791,8341,46468,17738,33942.71429,8994.285714,19716,47132,64206,42937
2/22/2023,3,Agency_3,Wednesday,46183,10560,Sports Event,1,177,56.74,72219,22243,21.2,10241,9475,29248,7806,36362,9387.714286,56743,19716,37054,45749.71429
2/23/2023,3,Agency_3,Thursday,30501,10252,Concert,0,177,40.75,72219,22243,29.25,46183,10560,15610,3346,38489.28571,10374.28571,40753,56743,18956,48863.57143
2/24/2023,3,Agency_3,Friday,23764,9379,Concert,1,177,33.14,72219,22243,33.23,30501,10252,36790,13646,36628.42857,9764.714286,33143,40753,50436,46393.14286
2/25/2023,3,Agency_3,Saturday,28765,3238,None,0,177,32,72219,22243,35.03,23764,9379,57486,10497,32525.42857,8727.714286,32003,33143,67983,41253.14286
2/26/2023,3,Agency_3,Sunday,50232,7072,Concert,1,177,57.31,72219,22243,21.61,28765,3238,49433,9849,32639.57143,8331,57304,32003,59282,40970.57143
2/27/2023,3,Agency_3,Monday,33498,8377,Concert,0,177,41.88,72219,22243,29.07,50232,7072,38791,8341,31883.42857,8336.142857,41875,57304,47132,40219.57143
2/28/2023,3,Agency_3,Tuesday,17886,12459,Festival,0,177,30.35,72219,22243,34.02,33498,8377,10241,9475,32975.57143,8762.428571,30345,41875,19716,41738
3/1/2023,3,Agency_3,Wednesday,31837,8042,Festival,1,177,39.88,72219,22243,30.13,17886,12459,46183,10560,30926.14286,8402.714286,39879,30345,56743,39328.85714
3/2/2023,3,Agency_3,Thursday,27302,10215,None,1,177,37.52,72219,22243,30.88,31837,8042,30501,10252,30469.14286,8397.428571,37517,39879,40753,38866.57143
3/3/2023,3,Agency_3,Friday,29094,12192,Concert,1,177,41.29,72219,22243,28.6,27302,10215,23764,9379,31230.57143,8799.285714,41286,37517,33143,40029.85714
3/4/2023,3,Agency_3,Saturday,51816,19758,Concert,1,177,71.58,72219,22243,11.94,29094,12192,28765,3238,34523.57143,11159.28571,71574,41286,32003,45682.85714
3/5/2023,3,Agency_3,Sunday,25058,5544,None,0,177,30.6,72219,22243,35.27,51816,19758,50232,7072,30927.28571,10941,30602,71574,57304,41868.28571
3/6/2023,3,Agency_3,Monday,23793,8792,Concert,0,177,32.59,72219,22243,33.63,25058,5544,33498,8377,29540.85714,11000.28571,32585,30602,41875,40541.14286
3/7/2023,3,Agency_3,Tuesday,21958,0,Festival,0,177,21.96,72219,22243,40.7,23793,8792,17886,12459,30122.57143,9220.428571,21958,32585,30345,39343
3/8/2023,3,Agency_3,Wednesday,22182,6807,None,0,177,28.99,72219,22243,35.82,21958,0,31837,8042,28743.28571,9044,28989,21958,39879,37787.28571
3/9/2023,3,Agency_3,Thursday,10640,4172,None,1,177,14.81,72219,22243,43.44,22182,6807,27302,10215,26363,8180.714286,14812,28989,37517,34543.71429
3/10/2023,3,Agency_3,Friday,45035,21691,Concert,1,177,66.73,72219,22243,13.98,10640,4172,29094,12192,28640.28571,9537.714286,66726,14812,41286,38178
3/11/2023,3,Agency_3,Saturday,31360,6448,None,1,177,37.81,72219,22243,31.49,45035,21691,51816,19758,25718,7636.285714,37808,66726,71574,33354.28571
3/12/2023,3,Agency_3,Sunday,44658,23975,Festival,1,177,68.63,72219,22243,12.57,31360,6448,25058,5544,28518,10269.28571,68633,37808,30602,38787.28571
3/13/2023,3,Agency_3,Monday,25155,5781,Sports Event,0,177,30.94,72219,22243,35.05,44658,23975,23793,8792,28712.57143,9839.142857,30936,68633,32585,38551.71429
3/14/2023,3,Agency_3,Tuesday,34292,7361,Sports Event,1,177,41.65,72219,22243,29.38,25155,5781,21958,0,30474.57143,10890.71429,41653,30936,21958,41365.28571
3/15/2023,3,Agency_3,Wednesday,30919,14023,Sports Event,0,177,44.94,72219,22243,26.4,34292,7361,22182,6807,31722.71429,11921.57143,44942,41653,28989,43644.28571
3/16/2023,3,Agency_3,Thursday,21615,4495,None,0,177,26.11,72219,22243,37.73,30919,14023,10640,4172,33290.57143,11967.71429,26110,44942,14812,45258.28571
3/17/2023,3,Agency_3,Friday,36153,4457,Sports Event,1,177,40.61,72219,22243,30.48,21615,4495,45035,21691,32021.71429,9505.714286,40610,26110,66726,41527.42857
3/18/2023,3,Agency_3,Saturday,57131,14987,Sports Event,1,177,72.12,72219,22243,12.62,36153,4457,31360,6448,35703.28571,10725.57143,72118,40610,37808,46428.85714
3/19/2023,3,Agency_3,Sunday,44686,35228,Concert,1,177,79.92,72219,22243,4.68,57131,14987,44658,23975,35707.28571,12333.14286,79914,72118,68633,48040.42857
3/20/2023,3,Agency_3,Monday,41911,8320,Concert,1,177,50.23,72219,22243,24.9,44686,35228,25155,5781,38101,12695.85714,50231,79914,30936,50796.85714
3/21/2023,3,Agency_3,Tuesday,34842,17364,Festival,1,177,52.21,72219,22243,22.1,41911,8320,34292,7361,38179.57143,14124.85714,52206,50231,41653,52304.42857
3/22/2023,3,Agency_3,Wednesday,30849,3609,Sports Event,0,177,34.46,72219,22243,33.73,34842,17364,30919,14023,38169.57143,12637.14286,34458,52206,44942,50806.71429
3/23/2023,3,Agency_3,Thursday,36894,6227,Festival,0,177,43.12,72219,22243,28.87,30849,3609,21615,4495,40352.28571,12884.57143,43121,34458,26110,53236.85714
3/24/2023,3,Agency_3,Friday,44049,12172,Festival,0,177,56.22,72219,22243,21.13,36894,6227,36153,4457,41480.28571,13986.71429,56221,43121,40610,55467
3/25/2023,3,Agency_3,Saturday,31973,16712,Sports Event,0,177,48.69,72219,22243,23.99,44049,12172,57131,14987,37886.28571,14233.14286,48685,56221,72118,52119.42857
3/26/2023,3,Agency_3,Sunday,47593,20745,Festival,1,177,68.34,72219,22243,13.36,31973,16712,44686,35228,38301.57143,12164.14286,68338,48685,79914,50465.71429
3/27/2023,3,Agency_3,Monday,33634,5621,Concert,0,177,39.26,72219,22243,30.93,47593,20745,41911,8320,37119.14286,11778.57143,39255,68338,50231,48897.71429
3/28/2023,3,Agency_3,Tuesday,16782,7059,None,0,177,23.84,72219,22243,38.35,33634,5621,34842,17364,34539.14286,10306.42857,23841,39255,52206,44845.57143
3/29/2023,3,Agency_3,Wednesday,35735,9976,Festival,1,177,45.71,72219,22243,26.83,16782,7059,30849,3609,35237.14286,11216,45711,23841,34458,46453.14286
3/30/2023,3,Agency_3,Thursday,22836,9939,Sports Event,0,177,32.78,72219,22243,33.3,35735,9976,36894,6227,33228.85714,11746.28571,32775,45711,43121,44975.14286
3/31/2023,3,Agency_3,Friday,59108,6816,Concert,1,177,65.92,72219,22243,17.35,22836,9939,44049,12172,35380.14286,10981.14286,65924,32775,56221,46361.28571
4/1/2023,3,Agency_3,Saturday,36217,17291,Festival,0,177,53.51,72219,22243,21.47,59108,6816,31973,16712,35986.42857,11063.85714,53508,65924,48685,47050.28571
4/2/2023,3,Agency_3,Sunday,45866,18266,Concert,1,177,64.13,72219,22243,15.96,36217,17291,47593,20745,35739.71429,10709.71429,64132,53508,68338,46449.42857
4/3/2023,3,Agency_3,Monday,28641,13937,Sports Event,1,177,42.58,72219,22243,27.6,45866,18266,33634,5621,35026.42857,11897.71429,42578,64132,39255,46924.14286
4/4/2023,3,Agency_3,Tuesday,37174,16590,Festival,1,177,53.77,72219,22243,21.48,28641,13937,16782,7059,37939.57143,13259.28571,53764,42578,23841,51198.85714
4/5/2023,3,Agency_3,Wednesday,25936,10179,None,0,177,36.12,72219,22243,31.59,37174,16590,35735,9976,36539.71429,13288.28571,36115,53764,45711,49828
4/6/2023,3,Agency_3,Thursday,44651,13449,Sports Event,1,177,58.1,72219,22243,19.94,25936,10179,22836,9939,39656.14286,13789.71429,58100,36115,32775,53445.85714
4/7/2023,3,Agency_3,Friday,31456,7298,Concert,0,177,38.75,72219,22243,30.84,44651,13449,59108,6816,35705.85714,13858.57143,38754,58100,65924,49564.42857
4/8/2023,3,Agency_3,Saturday,39045,9743,Festival,0,177,48.79,72219,22243,25.34,31456,7298,36217,17291,36109.85714,12780.28571,48788,38754,53508,48890.14286
4/9/2023,3,Agency_3,Sunday,32513,13895,None,1,177,46.41,72219,22243,25.7,39045,9743,45866,18266,34202.28571,12155.85714,46408,48788,64132,46358.14286
4/10/2023,3,Agency_3,Monday,29185,17324,Sports Event,1,177,46.51,72219,22243,24.96,32513,13895,28641,13937,34280,12639.71429,46509,46408,42578,46919.71429
4/11/2023,3,Agency_3,Tuesday,39877,8097,Festival,0,177,47.97,72219,22243,26.07,29185,17324,37174,16590,34666.14286,11426.42857,47974,46509,53764,46092.57143
4/12/2023,3,Agency_3,Wednesday,12207,5297,None,1,177,17.5,72219,22243,41.87,39877,8097,25936,10179,32704.85714,10729,17504,47974,36115,43433.85714
4/13/2023,3,Agency_3,Thursday,51643,11790,Concert,1,177,63.43,72219,22243,17.6,12207,5297,44651,13449,33703.71429,10492,63433,17504,58100,44195.71429
4/14/2023,3,Agency_3,Friday,29255,9496,Festival,1,177,38.75,72219,22243,30.4,51643,11790,31456,7298,33389.28571,10806,38751,63433,38754,44195.28571
4/15/2023,3,Agency_3,Saturday,43565,13465,Festival,0,177,57.03,72219,22243,20.47,29255,9496,39045,9743,34035,11337.71429,57030,38751,48788,45372.71429
4/16/2023,3,Agency_3,Sunday,33849,9427,Sports Event,0,177,43.28,72219,22243,28.16,43565,13465,32513,13895,34225.85714,10699.42857,43276,57030,46408,44925.28571
4/17/2023,3,Agency_3,Monday,35179,7508,Concert,1,177,42.69,72219,22243,28.83,33849,9427,29185,17324,35082.14286,9297.142857,42687,43276,46509,44379.28571
4/18/2023,3,Agency_3,Tuesday,42114,7403,Festival,0,177,49.52,72219,22243,25.44,35179,7508,39877,8097,35401.71429,9198,49517,42687,47974,44599.71429
4/19/2023,3,Agency_3,Wednesday,50865,19139,Sports Event,1,177,70.01,72219,22243,12.85,42114,7403,12207,5297,40924.28571,11175.42857,70004,49517,17504,52099.71429
4/20/2023,3,Agency_3,Thursday,37486,7031,Festival,0,177,44.52,72219,22243,28.01,50865,19139,51643,11790,38901.85714,10495.57143,44517,70004,63433,49397.42857
4/21/2023,3,Agency_3,Friday,33027,8416,Concert,0,177,41.44,72219,22243,29.27,37486,7031,29255,9496,39440.71429,10341.28571,41443,44517,38751,49782
4/22/2023,3,Agency_3,Saturday,36225,17474,Sports Event,1,177,53.7,72219,22243,21.33,33027,8416,43565,13465,38392.14286,10914,53699,41443,57030,49306.14286
4/23/2023,3,Agency_3,Sunday,33003,22818,Festival,1,177,55.82,72219,22243,19.21,36225,17474,33849,9427,38271.28571,12827,55821,53699,43276,51098.28571
4/24/2023,3,Agency_3,Monday,26514,9183,Concert,0,177,35.7,72219,22243,31.99,33003,22818,35179,7508,37033.42857,13066.28571,35697,55821,42687,50099.71429
4/25/2023,3,Agency_3,Tuesday,32124,7619,Sports Event,0,177,39.74,72219,22243,30.28,26514,9183,42114,7403,35606.28571,13097.14286,39743,35697,49517,48703.42857
4/26/2023,3,Agency_3,Wednesday,22933,4050,None,0,177,26.98,72219,22243,37.38,32124,7619,50865,19139,31616,10941.57143,26983,39743,70004,42557.57143
4/27/2023,3,Agency_3,Thursday,47494,5493,Concert,1,177,52.99,72219,22243,24.09,22933,4050,37486,7031,33045.71429,10721.85714,52987,26983,44517,43767.57143
4/28/2023,3,Agency_3,Friday,40230,21127,Sports Event,1,177,61.36,72219,22243,16.78,47494,5493,33027,8416,34074.71429,12537.71429,61357,52987,41443,46612.42857
4/29/2023,3,Agency_3,Saturday,26996,8053,Concert,0,177,35.05,72219,22243,32.54,40230,21127,36225,17474,32756.28571,11191.85714,35049,61357,53699,43948.14286
4/30/2023,3,Agency_3,Sunday,52811,16580,Festival,1,177,69.39,72219,22243,13.67,26996,8053,33003,22818,35586,10300.71429,69391,35049,55821,45886.71429
5/1/2023,3,Agency_3,Monday,42418,14227,Concert,1,177,56.65,72219,22243,20.51,52811,16580,26514,9183,37858,11021.28571,56645,69391,35697,48879.28571
5/2/2023,3,Agency_3,Tuesday,45187,17181,Festival,1,177,62.37,72219,22243,17.06,42418,14227,32124,7619,39724.14286,12387.28571,62368,56645,39743,52111.42857
5/3/2023,3,Agency_3,Wednesday,42995,10750,Sports Event,1,177,53.75,72219,22243,22.66,45187,17181,22933,4050,42590.14286,13344.42857,53745,62368,26983,55934.57143
5/4/2023,3,Agency_3,Thursday,35043,14958,Sports Event,0,177,50,72219,22243,23.69,42995,10750,47494,5493,40811.42857,14696.57143,50001,53745,52987,55508
5/5/2023,3,Agency_3,Friday,37705,7258,Festival,1,177,44.96,72219,22243,27.75,35043,14958,40230,21127,40450.71429,12715.28571,44963,50001,61357,53166
5/6/2023,3,Agency_3,Saturday,39834,8661,None,1,177,48.5,72219,22243,25.7,37705,7258,26996,8053,42284.71429,12802.14286,48495,44963,35049,55086.85714
5/7/2023,3,Agency_3,Sunday,16444,14793,Festival,0,177,31.24,72219,22243,33.1,39834,8661,52811,16580,37089.42857,12546.85714,31237,48495,69391,49636.28571
5/8/2023,3,Agency_3,Monday,33779,11466,Sports Event,1,177,45.25,72219,22243,26.76,16444,14793,42418,14227,35855.28571,12152.42857,45245,31237,56645,48007.71429
5/9/2023,3,Agency_3,Tuesday,32488,9146,Concert,0,177,41.63,72219,22243,29.03,33779,11466,45187,17181,34041.14286,11004.57143,41634,45245,62368,45045.71429
5/10/2023,3,Agency_3,Wednesday,35320,7019,Sports Event,0,177,42.34,72219,22243,29.11,32488,9146,42995,10750,32944.71429,10471.57143,42339,41634,53745,43416.28571
5/11/2023,3,Agency_3,Thursday,33847,7616,Sports Event,0,177,41.46,72219,22243,29.42,35320,7019,35043,14958,32773.85714,9422.714286,41463,42339,50001,42196.57143
5/12/2023,3,Agency_3,Friday,35541,10591,Concert,0,177,46.13,72219,22243,26.5,33847,7616,37705,7258,32464.71429,9898.857143,46132,41463,44963,42363.57143
5/13/2023,3,Agency_3,Saturday,18386,9322,None,0,177,27.71,72219,22243,35.96,35541,10591,39834,8661,29400.71429,9993.285714,27708,46132,48495,39394
5/14/2023,3,Agency_3,Sunday,27019,12041,None,1,177,39.06,72219,22243,29.74,18386,9322,16444,14793,30911.42857,9600.142857,39060,27708,31237,40511.57143
5/15/2023,3,Agency_3,Monday,42580,20648,Festival,1,177,63.23,72219,22243,15.94,27019,12041,33779,11466,32168.71429,10911.85714,63228,39060,45245,43080.57143
5/16/2023,3,Agency_3,Tuesday,36819,10236,Concert,1,177,47.06,72219,22243,26.1,42580,20648,32488,9146,32787.42857,11067.57143,47055,63228,41634,43855
5/17/2023,3,Agency_3,Wednesday,38808,10455,Concert,1,177,49.26,72219,22243,24.96,36819,10236,35320,7019,33285.71429,11558.42857,49263,47055,42339,44844.14286
5/18/2023,3,Agency_3,Thursday,35998,3003,Sports Event,0,177,39,72219,22243,31.58,38808,10455,33847,7616,33593,10899.42857,39001,49263,41463,44492.42857
5/19/2023,3,Agency_3,Friday,22096,4868,Concert,0,177,26.97,72219,22243,37.22,35998,3003,35541,10591,31672.28571,10081.85714,26964,39001,46132,41754.14286
5/20/2023,3,Agency_3,Saturday,57917,26054,Festival,1,177,83.97,72219,22243,4.48,22096,4868,18386,9322,37319.57143,12472.14286,83971,26964,27708,49791.71429
5/21/2023,3,Agency_3,Sunday,45576,14424,Sports Event,1,177,60,72219,22243,18.79,57917,26054,27019,12041,39970.57143,12812.57143,60000,83971,39060,52783.14286
5/22/2023,3,Agency_3,Monday,39682,17428,Concert,1,177,57.11,72219,22243,19.64,45576,14424,42580,20648,39556.57143,12352.57143,57110,60000,63228,51909.14286
5/23/2023,3,Agency_3,Tuesday,29957,13032,Festival,1,177,42.99,72219,22243,27.58,39682,17428,36819,10236,38576.28571,12752,42989,57110,47055,51328.28571
5/24/2023,3,Agency_3,Wednesday,48506,14284,Festival,1,177,62.79,72219,22243,17.43,29957,13032,38808,10455,39961.71429,13299,62790,42989,49263,53260.71429
5/25/2023,3,Agency_3,Thursday,31420,11903,Concert,0,177,43.32,72219,22243,27.64,48506,14284,35998,3003,39307.71429,14570.42857,43323,62790,39001,53878.14286
5/26/2023,3,Agency_3,Friday,12641,15124,Festival,1,177,27.77,72219,22243,34.77,31420,11903,22096,4868,37957,16035.57143,27765,43323,26964,53992.57143
5/27/2023,3,Agency_3,Saturday,39145,4139,Concert,1,177,43.29,72219,22243,29.21,12641,15124,57917,26054,35275.28571,12904.85714,43284,27765,83971,48180.14286
5/28/2023,3,Agency_3,Sunday,40600,17120,Festival,0,177,57.72,72219,22243,19.39,39145,4139,45576,14424,34564.42857,13290,57720,43284,60000,47854.42857
5/29/2023,3,Agency_3,Monday,37658,16433,Sports Event,1,177,54.09,72219,22243,21.35,40600,17120,39682,17428,34275.28571,13147.85714,54091,57720,57110,47423.14286
5/30/2023,3,Agency_3,Tuesday,54718,18157,Sports Event,1,177,72.88,72219,22243,11.61,37658,16433,29957,13032,37812.57143,13880,72875,54091,42989,51692.57143
5/31/2023,3,Agency_3,Wednesday,54988,15431,Festival,1,177,70.42,72219,22243,13.38,54718,18157,48506,14284,38738.57143,14043.85714,70419,72875,62790,52782.42857
6/1/2023,3,Agency_3,Thursday,26490,2514,None,1,177,29,72219,22243,36.67,54988,15431,31420,11903,38034.28571,12702.57143,29004,70419,43323,50736.85714
6/2/2023,3,Agency_3,Friday,36599,7884,Sports Event,1,177,44.48,72219,22243,27.86,26490,2514,12641,15124,41456.85714,11668.28571,44483,29004,27765,53125.14286
6/3/2023,3,Agency_3,Saturday,72198,14380,Concert,1,177,86.58,72219,22243,5.51,36599,7884,39145,4139,46178.71429,13131.28571,86578,44483,43284,59310
6/4/2023,3,Agency_3,Sunday,32160,11105,None,1,177,43.27,72219,22243,27.83,72198,14380,40600,17120,44973,12272,43265,86578,57720,57245
6/5/2023,3,Agency_3,Monday,26283,11746,None,1,177,38.03,72219,22243,30.32,32160,11105,37658,16433,43348,11602.42857,38029,43265,54091,54950.42857
6/6/2023,3,Agency_3,Tuesday,32927,12825,Sports Event,1,177,45.75,72219,22243,26.24,26283,11746,54718,18157,40235,10840.71429,45752,38029,72875,51075.71429
6/7/2023,3,Agency_3,Wednesday,24430,4010,Sports Event,0,177,28.44,72219,22243,36.66,32927,12825,54988,15431,35869.57143,9209.142857,28440,45752,70419,45078.71429
6/8/2023,3,Agency_3,Thursday,33034,11721,Concert,1,177,44.76,72219,22243,26.96,24430,4010,26490,2514,36804.42857,10524.42857,44755,28440,29004,47328.85714
6/9/2023,3,Agency_3,Friday,26779,6145,Festival,0,177,32.92,72219,22243,33.99,33034,11721,36599,7884,35401.57143,10276,32924,44755,44483,45677.57143
6/10/2023,3,Agency_3,Saturday,15561,6282,None,0,177,21.84,72219,22243,39.5,26779,6145,72198,14380,27310.57143,9119.142857,21843,32924,86578,36429.71429
6/11/2023,3,Agency_3,Sunday,22456,14409,Concert,0,177,36.87,72219,22243,30.36,15561,6282,32160,11105,25924.28571,9591.142857,36865,21843,43265,35515.42857
6/12/2023,3,Agency_3,Monday,30618,3542,Concert,0,177,34.16,72219,22243,33.89,22456,14409,26283,11746,26543.57143,8419.142857,34160,36865,38029,34962.71429
6/13/2023,3,Agency_3,Tuesday,18453,3495,None,0,177,21.95,72219,22243,40.01,30618,3542,32927,12825,24475.85714,7086.285714,21948,34160,45752,31562.14286
6/14/2023,3,Agency_3,Wednesday,42110,18278,Sports Event,1,177,60.39,72219,22243,17.83,18453,3495,24430,4010,27001.57143,9124.571429,60388,21948,28440,36126.14286
6/15/2023,3,Agency_3,Thursday,15936,8891,Sports Event,0,177,24.83,72219,22243,37.49,42110,18278,33034,11721,24559,8720.285714,24827,60388,44755,33279.28571
6/16/2023,3,Agency_3,Friday,28798,10781,Concert,0,177,39.58,72219,22243,29.73,15936,8891,26779,6145,24847.42857,9382.571429,39579,24827,32924,34230
6/17/2023,3,Agency_3,Saturday,49292,10816,Concert,1,177,60.11,72219,22243,19.46,28798,10781,15561,6282,29666.14286,10030.28571,60108,39579,21843,39696.42857
6/18/2023,3,Agency_3,Sunday,43065,10541,Sports Event,1,177,53.61,72219,22243,22.77,49292,10816,22456,14409,32610.28571,9477.714286,53606,60108,36865,42088
6/19/2023,3,Agency_3,Monday,49491,11999,Concert,1,177,61.49,72219,22243,18.53,43065,10541,30618,3542,35306.42857,10685.85714,61490,53606,34160,45992.28571
6/20/2023,3,Agency_3,Tuesday,57534,11609,Festival,1,177,69.14,72219,22243,14.79,49491,11999,18453,3495,40889.42857,11845,69143,61490,21948,52734.42857
6/21/2023,3,Agency_3,Wednesday,16457,1972,None,0,177,18.43,72219,22243,42.07,57534,11609,42110,18278,37224.71429,9515.571429,18429,69143,60388,46740.28571
6/22/2023,3,Agency_3,Thursday,16476,3112,Concert,0,177,19.59,72219,22243,41.26,16457,1972,15936,8891,37301.85714,8690,19588,18429,24827,45991.85714
6/23/2023,3,Agency_3,Friday,41603,14320,Concert,1,177,55.92,72219,22243,20.85,16476,3112,28798,10781,39131.14286,9195.571429,55923,19588,39579,48326.71429
6/24/2023,3,Agency_3,Saturday,21769,15005,Concert,0,177,36.78,72219,22243,30.29,41603,14320,49292,10816,35199.28571,9794,36774,55923,60108,44993.28571
6/25/2023,3,Agency_3,Sunday,41146,16376,Sports Event,1,177,57.52,72219,22243,19.64,21769,15005,43065,10541,34925.14286,10627.57143,57522,36774,53606,45552.71429
6/26/2023,3,Agency_3,Monday,54718,16167,Concert,1,177,70.89,72219,22243,13,41146,16376,49491,11999,35671.85714,11223,70885,57522,61490,46894.85714
6/27/2023,3,Agency_3,Tuesday,18657,3217,None,0,177,21.87,72219,22243,40.1,54718,16167,57534,11609,30118,10024.14286,21874,70885,69143,40142.14286
6/28/2023,3,Agency_3,Wednesday,13860,6053,Festival,0,177,19.91,72219,22243,40.51,18657,3217,16457,1972,29747,10607.14286,19913,21874,18429,40354.14286
6/29/2023,3,Agency_3,Thursday,36940,7199,Festival,1,177,44.14,72219,22243,28.17,13860,6053,16476,3112,32670.42857,11191,44139,19913,19588,43861.42857
6/30/2023,3,Agency_3,Friday,37718,12264,Sports Event,1,177,49.98,72219,22243,24.24,36940,7199,41603,14320,32115.42857,10897.28571,49982,44139,55923,43012.71429
7/1/2023,3,Agency_3,Saturday,44167,11444,Concert,1,177,55.61,72219,22243,21.58,37718,12264,21769,15005,35315.14286,10388.57143,55611,49982,36774,45703.71429
7/2/2023,3,Agency_3,Sunday,37517,13001,Festival,0,177,50.52,72219,22243,23.82,44167,11444,41146,16376,34796.71429,9906.428571,50518,55611,57522,44703.14286
7/3/2023,3,Agency_3,Monday,18912,10949,None,1,177,29.86,72219,22243,34.56,37517,13001,54718,16167,29681.57143,9161,29861,50518,70885,38842.57143
7/4/2023,3,Agency_3,Tuesday,38038,11988,Concert,1,177,50.03,72219,22243,24.27,18912,10949,18657,3217,32450.28571,10414,50026,29861,21874,42864.28571
7/5/2023,3,Agency_3,Wednesday,35311,9292,Festival,0,177,44.6,72219,22243,27.52,38038,11988,13860,6053,35514.71429,10876.71429,44603,50026,19913,46391.42857
7/6/2023,3,Agency_3,Thursday,32194,7803,None,1,177,40,72219,22243,30.12,35311,9292,36940,7199,34836.71429,10963,39997,44603,44139,45799.71429
7/7/2023,3,Agency_3,Friday,25405,9729,Festival,0,177,35.13,72219,22243,32.17,32194,7803,37718,12264,33077.71429,10600.85714,35134,39997,49982,43678.57143
7/8/2023,3,Agency_3,Saturday,33417,16141,Concert,1,177,49.56,72219,22243,23.67,25405,9729,44167,11444,31542,11271.85714,49558,35134,55611,42813.85714
7/9/2023,3,Agency_3,Sunday,46409,14179,Sports Event,1,177,60.59,72219,22243,18.55,33417,16141,37517,13001,32812.28571,11440.14286,60588,49558,50518,44252.42857
7/10/2023,3,Agency_3,Monday,25164,1730,None,1,177,26.89,72219,22243,37.89,46409,14179,18912,10949,33705.42857,10123.14286,26894,60588,29861,43828.57143
7/11/2023,3,Agency_3,Tuesday,17256,5185,None,0,177,22.44,72219,22243,39.42,25164,1730,38038,11988,30736.57143,9151.285714,22441,26894,50026,39887.85714
7/12/2023,3,Agency_3,Wednesday,40558,7006,Concert,1,177,47.56,72219,22243,26.5,17256,5185,35311,9292,31486.14286,8824.714286,47564,22441,44603,40310.85714
7/13/2023,3,Agency_3,Thursday,39492,5553,Festival,0,177,45.05,72219,22243,28.05,40558,7006,32194,7803,32528.71429,8503.285714,45045,47564,39997,41032
7/14/2023,3,Agency_3,Friday,32301,8195,None,1,177,40.5,72219,22243,29.79,39492,5553,25405,9729,33513.85714,8284.142857,40496,45045,35134,41798
7/15/2023,3,Agency_3,Saturday,30182,18895,Sports Event,0,177,49.08,72219,22243,23.36,32301,8195,33417,16141,33051.71429,8677.571429,49077,40496,49558,41729.28571
7/16/2023,3,Agency_3,Sunday,32832,21156,Sports Event,1,177,53.99,72219,22243,20.45,30182,18895,46409,14179,31112.14286,9674.285714,53988,49077,60588,40786.42857
7/17/2023,3,Agency_3,Monday,48753,8706,Festival,1,177,57.46,72219,22243,21.21,32832,21156,25164,1730,34482,10670.85714,57459,53988,26894,45152.85714
7/18/2023,3,Agency_3,Tuesday,35050,6298,None,1,177,41.35,72219,22243,29.75,48753,8706,17256,5185,37024,10829.85714,41348,57459,22441,47853.85714
7/19/2023,3,Agency_3,Wednesday,32164,9384,Festival,0,177,41.55,72219,22243,29.03,35050,6298,40558,7006,35824.85714,11169.57143,41548,41348,47564,46994.42857
7/20/2023,3,Agency_3,Thursday,19328,6621,None,0,177,25.95,72219,22243,37.38,32164,9384,39492,5553,32944.28571,11322.14286,25949,41548,45045,44266.42857
7/21/2023,3,Agency_3,Friday,46735,3574,Sports Event,1,177,50.31,72219,22243,25.81,19328,6621,32301,8195,35006.28571,10662,50309,25949,40496,45668.28571
7/22/2023,3,Agency_3,Saturday,62059,5182,Concert,1,177,67.24,72219,22243,17.02,46735,3574,30182,18895,39560.14286,8703,67241,50309,49077,48263.14286
7/23/2023,3,Agency_3,Sunday,45291,16029,Festival,0,177,61.32,72219,22243,17.81,62059,5182,32832,21156,41340,7970.571429,61320,67241,53988,49310.57143
7/24/2023,3,Agency_3,Monday,28362,9943,Festival,1,177,38.31,72219,22243,30.54,45291,16029,48753,8706,38427,8147.285714,38305,61320,57459,46574.28571
7/25/2023,3,Agency_3,Tuesday,21706,7769,Concert,0,177,29.48,72219,22243,35.39,28362,9943,35050,6298,36520.71429,8357.428571,29475,38305,41348,44878.14286
7/26/2023,3,Agency_3,Wednesday,35995,15610,Concert,1,177,51.61,72219,22243,22.75,21706,7769,32164,9384,37068,9246.857143,51605,29475,41548,46314.85714
7/27/2023,3,Agency_3,Thursday,51774,18542,Concert,1,177,70.32,72219,22243,12.81,35995,15610,19328,6621,41703.14286,10949.85714,70316,51605,25949,52653
7/28/2023,3,Agency_3,Friday,33518,10902,Festival,1,177,44.42,72219,22243,27.29,51774,18542,46735,3574,39815,11996.71429,44420,70316,50309,51811.71429
7/29/2023,3,Agency_3,Saturday,20847,7487,Sports Event,0,177,28.34,72219,22243,36.01,33518,10902,62059,5182,33927.57143,12326,28334,44420,67241,46253.57143
7/30/2023,3,Agency_3,Sunday,44683,18190,Concert,0,177,62.87,72219,22243,16.6,20847,7487,45291,16029,33840.71429,12634.71429,62873,28334,61320,46475.42857
7/31/2023,3,Agency_3,Monday,26964,9079,Sports Event,1,177,36.04,72219,22243,31.84,44683,18190,28362,9943,33641,12511.28571,36043,62873,38305,46152.28571
8/1/2023,3,Agency_3,Tuesday,19867,5560,None,0,177,25.43,72219,22243,37.85,26964,9079,21706,7769,33378.28571,12195.71429,25427,36043,29475,45574
8/2/2023,3,Agency_3,Wednesday,15951,5848,None,0,177,21.8,72219,22243,39.61,19867,5560,35995,15610,30514.85714,10801.14286,21799,25427,51605,41316
8/3/2023,3,Agency_3,Thursday,26445,8450,Concert,0,177,34.9,72219,22243,32.54,15951,5848,51774,18542,26896.42857,9359.428571,34895,21799,70316,36255.85714
8/4/2023,3,Agency_3,Friday,44325,11928,Festival,1,177,56.25,72219,22243,21.17,26445,8450,33518,10902,28440.28571,9506,56253,34895,44420,37946.28571
8/5/2023,3,Agency_3,Saturday,21381,6214,None,0,177,27.6,72219,22243,36.64,44325,11928,20847,7487,28516.57143,9324.142857,27595,56253,28334,37840.71429
8/6/2023,3,Agency_3,Sunday,35204,9412,Sports Event,0,177,44.62,72219,22243,27.49,21381,6214,44683,18190,27162.42857,8070.142857,44616,27595,62873,35232.57143
8/7/2023,3,Agency_3,Monday,28059,13934,Sports Event,0,177,41.99,72219,22243,27.9,35204,9412,26964,9079,27318.85714,8763.714286,41993,44616,36043,36082.57143
8/8/2023,3,Agency_3,Tuesday,34206,7495,Sports Event,0,177,41.7,72219,22243,29.33,28059,13934,19867,5560,29367.28571,9040.142857,41701,41993,25427,38407.42857
8/9/2023,3,Agency_3,Wednesday,45793,10310,Sports Event,1,177,56.1,72219,22243,21.57,34206,7495,15951,5848,33630.42857,9677.571429,56103,41701,21799,43308
8/10/2023,3,Agency_3,Thursday,33624,8034,None,1,177,41.66,72219,22243,29.24,45793,10310,26445,8450,34656,9618.142857,41658,56103,34895,44274.14286
8/11/2023,3,Agency_3,Friday,29194,10021,Festival,0,177,39.22,72219,22243,30.07,33624,8034,44325,11928,32494.42857,9345.714286,39215,41658,56253,41840.14286
8/12/2023,3,Agency_3,Saturday,28419,8496,Sports Event,1,177,36.92,72219,22243,31.52,29194,10021,21381,6214,33499.85714,9671.714286,36915,39215,27595,43171.57143
8/13/2023,3,Agency_3,Sunday,16836,6870,None,0,177,23.71,72219,22243,38.45,28419,8496,35204,9412,30875.85714,9308.571429,23706,36915,44616,40184.42857
8/14/2023,3,Agency_3,Monday,28662,9462,None,0,177,38.12,72219,22243,30.73,16836,6870,28059,13934,30962,8669.714286,38124,23706,41993,39631.71429
8/15/2023,3,Agency_3,Tuesday,45220,14282,Sports Event,1,177,59.5,72219,22243,19.07,28662,9462,34206,7495,32535.42857,9639.285714,59502,38124,41701,42174.71429
8/16/2023,3,Agency_3,Wednesday,10994,3914,None,0,177,14.91,72219,22243,43.44,45220,14282,45793,10310,27564.14286,8725.571429,14908,59502,56103,36289.71429
8/17/2023,3,Agency_3,Thursday,20879,5261,None,1,177,26.14,72219,22243,37.56,10994,3914,33624,8034,25743.42857,8329.428571,26140,14908,41658,34072.85714
8/18/2023,3,Agency_3,Friday,24906,5677,None,1,177,30.58,72219,22243,35.25,20879,5261,29194,10021,25130.85714,7708.857143,30583,26140,39215,32839.71429
8/19/2023,3,Agency_3,Saturday,18185,14353,Sports Event,0,177,32.54,72219,22243,32.54,24906,5677,28419,8496,23668.85714,8545.571429,32538,30583,36915,32214.42857
8/20/2023,3,Agency_3,Sunday,34248,16948,Concert,1,177,51.2,72219,22243,22.69,18185,14353,16836,6870,26156.28571,9985.285714,51196,32538,23706,36141.57143
8/21/2023,3,Agency_3,Monday,59221,7523,Festival,1,177,66.74,72219,22243,16.8,34248,16948,28662,9462,30521.85714,9708.285714,66744,51196,38124,40230.14286
8/22/2023,3,Agency_3,Tuesday,14328,10536,Sports Event,1,177,24.86,72219,22243,37.14,59221,7523,45220,14282,26108.71429,9173.142857,24864,66744,59502,35281.85714
8/23/2023,3,Agency_3,Wednesday,38256,15157,Sports Event,0,177,53.41,72219,22243,21.94,14328,10536,10994,3914,30003.28571,10779.28571,53413,24864,14908,40782.57143
8/24/2023,3,Agency_3,Thursday,27011,14263,Concert,1,177,41.27,72219,22243,28.19,38256,15157,20879,5261,30879.28571,12065.28571,41274,53413,26140,42944.57143
8/25/2023,3,Agency_3,Friday,17673,4788,None,0,177,22.46,72219,22243,39.49,27011,14263,24906,5677,29846,11938.28571,22461,41274,30583,41784.28571
8/26/2023,3,Agency_3,Saturday,59797,4406,Sports Event,0,177,64.2,72219,22243,18.7,17673,4788,18185,14353,35790.57143,10517.28571,64203,22461,32538,46307.85714
8/27/2023,3,Agency_3,Sunday,38282,13116,Concert,0,177,51.4,72219,22243,23.36,59797,4406,34248,16948,36366.85714,9969.857143,51398,64203,51196,46336.71429
8/28/2023,3,Agency_3,Monday,33056,7272,None,1,177,40.33,72219,22243,30.06,38282,13116,59221,7523,32629,9934,40328,51398,66744,42563
8/29/2023,3,Agency_3,Tuesday,42003,10034,Sports Event,1,177,52.04,72219,22243,23.65,33056,7272,14328,10536,36582.57143,9862.285714,52037,40328,24864,46444.85714
8/30/2023,3,Agency_3,Wednesday,32017,7332,Sports Event,0,177,39.35,72219,22243,30.54,42003,10034,38256,15157,35691.28571,8744.428571,39349,52037,53413,44435.71429
8/31/2023,3,Agency_3,Thursday,45058,10138,Concert,1,177,55.2,72219,22243,22.05,32017,7332,27011,14263,38269.42857,8155.142857,55196,39349,41274,46424.57143
9/1/2023,3,Agency_3,Friday,32827,8399,Festival,0,177,41.23,72219,22243,29.39,45058,10138,17673,4788,40434.28571,8671,41226,55196,22461,49105.28571
9/2/2023,3,Agency_3,Saturday,46134,10822,Festival,0,177,56.96,72219,22243,21.04,32827,8399,59797,4406,38482.42857,9587.571429,56956,41226,64203,48070
9/3/2023,3,Agency_3,Sunday,13360,9779,None,0,177,23.14,72219,22243,38.15,46134,10822,38282,13116,34922.14286,9110.857143,23139,56956,51398,44033
9/4/2023,3,Agency_3,Monday,23206,6276,Sports Event,0,177,29.48,72219,22243,35.68,13360,9779,33056,7272,33515,8968.571429,29482,23139,40328,42483.57143
9/5/2023,3,Agency_3,Tuesday,25531,13171,Concert,0,177,38.7,72219,22243,29.69,23206,6276,42003,10034,31161.85714,9416.714286,38702,29482,52037,40578.57143
9/6/2023,3,Agency_3,Wednesday,9321,11275,None,0,177,20.6,72219,22243,39.13,25531,13171,32017,7332,27919.57143,9980,20596,38702,39349,37899.57143
9/7/2023,3,Agency_3,Thursday,32864,7624,None,1,177,40.49,72219,22243,29.91,9321,11275,45058,10138,26177.57143,9620.857143,40488,20596,55196,35798.42857
9/8/2023,3,Agency_3,Friday,19725,5571,None,0,177,25.3,72219,22243,37.92,32864,7624,32827,8399,24305.85714,9216.857143,25296,40488,41226,33522.71429
9/9/2023,3,Agency_3,Saturday,35263,11447,None,1,177,46.71,72219,22243,26.03,19725,5571,46134,10822,22752.85714,9306.142857,46710,25296,56956,32059
9/10/2023,3,Agency_3,Sunday,41000,11445,Sports Event,0,177,52.45,72219,22243,23.17,35263,11447,13360,9779,26701.42857,9544.142857,52445,46710,23139,36245.57143
9/11/2023,3,Agency_3,Monday,28519,7984,Concert,0,177,36.5,72219,22243,31.83,41000,11445,23206,6276,27460.42857,9788.142857,36503,52445,29482,37248.57143
9/12/2023,3,Agency_3,Tuesday,37098,17295,Concert,1,177,54.39,72219,22243,21.02,28519,7984,25531,13171,29112.85714,10377.28571,54393,36503,38702,39490.14286
9/13/2023,3,Agency_3,Wednesday,44785,0,Concert,1,177,44.79,72219,22243,29.29,37098,17295,9321,11275,34179.14286,8766.571429,44785,54393,20596,42945.71429
9/14/2023,3,Agency_3,Thursday,34918,9161,Festival,0,177,44.08,72219,22243,27.81,44785,0,32864,7624,34472.57143,8986.142857,44079,44785,40488,43458.71429
9/15/2023,3,Agency_3,Friday,29859,7177,Festival,0,177,37.04,72219,22243,31.73,34918,9161,19725,5571,35920.28571,9215.571429,37036,44079,25296,45135.85714
9/16/2023,3,Agency_3,Saturday,59950,21333,Concert,1,177,81.28,72219,22243,6.77,29859,7177,35263,11447,39447,10627.85714,81283,37036,46710,50074.85714
9/17/2023,3,Agency_3,Sunday,37755,17988,Festival,1,177,55.74,72219,22243,20.21,59950,21333,41000,11445,38983.42857,11562.57143,55743,81283,52445,50546
9/18/2023,3,Agency_3,Monday,15141,2240,None,0,177,17.38,72219,22243,42.54,37755,17988,28519,7984,37072.28571,10742,17381,55743,36503,47814.28571
9/19/2023,3,Agency_3,Tuesday,32888,16003,Sports Event,1,177,48.89,72219,22243,24.03,15141,2240,37098,17295,36470.85714,10557.42857,48891,17381,54393,47028.28571
9/20/2023,3,Agency_3,Wednesday,32194,8436,None,1,177,40.63,72219,22243,29.68,32888,16003,44785,0,34672.14286,11762.57143,40630,48891,44785,46434.71429
9/21/2023,3,Agency_3,Thursday,46068,14356,Sports Event,1,177,60.42,72219,22243,18.6,32194,8436,34918,9161,36265,12504.71429,60424,40630,44079,48769.71429
9/22/2023,3,Agency_3,Friday,32744,13953,Sports Event,1,177,46.7,72219,22243,25.54,46068,14356,29859,7177,36677.14286,13472.71429,46697,60424,37036,50149.85714
9/23/2023,3,Agency_3,Saturday,56164,20135,Concert,1,177,76.3,72219,22243,9.5,32744,13953,59950,21333,36136.28571,13301.57143,76299,46697,81283,49437.85714
9/24/2023,3,Agency_3,Sunday,46699,14179,Sports Event,0,177,60.88,72219,22243,18.4,56164,20135,37755,17988,37414,12757.42857,60878,76299,55743,50171.42857
9/25/2023,3,Agency_3,Monday,32635,12138,Sports Event,0,177,44.77,72219,22243,26.87,46699,14179,15141,2240,39913.14286,14171.42857,44773,60878,17381,54084.57143
9/26/2023,3,Agency_3,Tuesday,38740,7701,Concert,1,177,46.44,72219,22243,26.92,32635,12138,32888,16003,40749.14286,12985.42857,46441,44773,48891,53734.57143
9/27/2023,3,Agency_3,Wednesday,37408,8353,Concert,1,177,45.76,72219,22243,27.13,38740,7701,32194,8436,41494,12973.57143,45761,46441,40630,54467.57143
9/28/2023,3,Agency_3,Thursday,21611,6594,None,1,177,28.21,72219,22243,36.26,37408,8353,46068,14356,38000.14286,11864.71429,28205,45761,60424,49864.85714
9/29/2023,3,Agency_3,Friday,24055,7452,Sports Event,0,177,31.51,72219,22243,34.43,21611,6594,32744,13953,36758.85714,10936,31507,28205,46697,47694.85714
9/30/2023,3,Agency_3,Saturday,18955,11991,Sports Event,0,177,30.95,72219,22243,33.81,24055,7452,56164,20135,31443.28571,9772.571429,30946,31507,76299,41215.85714
10/1/2023,3,Agency_3,Sunday,36010,7436,Festival,0,177,43.45,72219,22243,28.47,18955,11991,46699,14179,29916.28571,8809.285714,43446,30946,60878,38725.57143
10/2/2023,3,Agency_3,Monday,34944,11687,Festival,0,177,46.63,72219,22243,26.03,36010,7436,32635,12138,30246.14286,8744.857143,46631,43446,44773,38991
10/3/2023,3,Agency_3,Tuesday,23325,8268,Sports Event,1,177,31.59,72219,22243,34.23,34944,11687,38740,7701,28044,8825.857143,31593,46631,46441,36869.85714
10/4/2023,3,Agency_3,Wednesday,16154,3120,None,0,177,19.27,72219,22243,41.42,23325,8268,37408,8353,25007.71429,8078.285714,19274,31593,45761,33086
10/5/2023,3,Agency_3,Thursday,31391,6456,None,1,177,37.85,72219,22243,31.46,16154,3120,21611,6594,26404.85714,8058.571429,37847,19274,28205,34463.42857
10/6/2023,3,Agency_3,Friday,28015,1686,Sports Event,0,177,29.7,72219,22243,36.49,31391,6456,24055,7452,26970.57143,7234.857143,29701,37847,31507,34205.42857
10/7/2023,3,Agency_3,Saturday,27812,3277,None,0,177,31.09,72219,22243,35.48,28015,1686,18955,11991,28235.85714,5990,31089,29701,30946,34225.85714
10/8/2023,3,Agency_3,Sunday,47499,17184,Concert,1,177,64.68,72219,22243,15.9,27812,3277,36010,7436,29877.14286,7382.571429,64683,31089,43446,37259.71429
10/9/2023,3,Agency_3,Monday,52265,5669,Concert,1,177,57.94,72219,22243,21.58,47499,17184,34944,11687,32351.57143,6522.857143,57934,64683,46631,38874.42857
10/10/2023,3,Agency_3,Tuesday,7353,9123,Festival,0,177,16.48,72219,22243,41.62,52265,5669,23325,8268,30069.85714,6645,16476,57934,31593,36714.85714
10/11/2023,3,Agency_3,Wednesday,43503,12710,Concert,0,177,56.21,72219,22243,21.03,7353,9123,16154,3120,33976.85714,8015,56213,16476,19274,41991.85714
10/12/2023,3,Agency_3,Thursday,27362,5622,None,1,177,32.98,72219,22243,34.06,43503,12710,31391,6456,33401.28571,7895.857143,32984,56213,37847,41297.14286
10/13/2023,3,Agency_3,Friday,36052,5188,Concert,0,177,41.24,72219,22243,30.02,27362,5622,28015,1686,34549.42857,8396.142857,41240,32984,29701,42945.57143
10/14/2023,3,Agency_3,Saturday,40285,13282,Sports Event,0,177,53.57,72219,22243,22.24,36052,5188,27812,3277,36331.28571,9825.428571,53567,41240,31089,46156.71429
10/15/2023,3,Agency_3,Sunday,59204,32545,Festival,1,177,91.75,72219,22243,-0.7,40285,13282,47499,17184,38003.42857,12019.85714,91749,53567,64683,50023.28571
10/16/2023,3,Agency_3,Monday,42825,9477,Sports Event,1,177,52.3,72219,22243,23.63,59204,32545,52265,5669,36654.85714,12563.85714,52302,91749,57934,49218.71429
10/17/2023,3,Agency_3,Tuesday,38750,3477,Festival,1,177,42.23,72219,22243,29.87,42825,9477,7353,9123,41140.14286,11757.28571,42227,52302,16476,52897.42857
10/18/2023,3,Agency_3,Wednesday,32225,9950,Festival,1,177,42.18,72219,22243,28.6,38750,3477,43503,12710,39529,11363,42175,42227,56213,50892
10/19/2023,3,Agency_3,Thursday,33889,12623,Sports Event,1,177,46.51,72219,22243,25.9,32225,9950,27362,5622,40461.42857,12363.14286,46512,42175,32984,52824.57143
10/20/2023,3,Agency_3,Friday,20653,10138,None,1,177,30.79,72219,22243,34.26,33889,12623,36052,5188,38261.57143,13070.28571,30791,46512,41240,51331.85714
10/21/2023,3,Agency_3,Saturday,36001,11008,Festival,0,177,47.01,72219,22243,25.97,20653,10138,40285,13282,37649.57143,12745.42857,47009,30791,53567,50395
10/22/2023,3,Agency_3,Sunday,42962,16429,Festival,1,177,59.39,72219,22243,18.7,36001,11008,59204,32545,35329.28571,10443.14286,59391,47009,91749,45772.42857
10/23/2023,3,Agency_3,Monday,36187,5550,Sports Event,0,177,41.74,72219,22243,29.7,42962,16429,42825,9477,34381,9882.142857,41737,59391,52302,44263.14286
10/24/2023,3,Agency_3,Tuesday,25063,7466,Concert,0,177,32.53,72219,22243,33.92,36187,5550,38750,3477,32425.71429,10452,32529,41737,42227,42877.71429
10/25/2023,3,Agency_3,Wednesday,17251,4705,None,1,177,21.96,72219,22243,39.76,25063,7466,32225,9950,30286.57143,9702.714286,21956,32529,42175,39989.28571
10/26/2023,3,Agency_3,Thursday,34355,16060,Sports Event,1,177,50.42,72219,22243,23.26,17251,4705,33889,12623,30353.14286,10193.71429,50415,21956,46512,40546.85714
10/27/2023,3,Agency_3,Friday,31968,9157,Concert,0,177,41.13,72219,22243,29.29,34355,16060,20653,10138,31969.57143,10053.57143,41125,50415,30791,42023.14286
10/28/2023,3,Agency_3,Saturday,43657,10442,Festival,0,177,54.1,72219,22243,22.54,31968,9157,36001,11008,33063.28571,9972.714286,54099,41125,47009,43036
10/29/2023,3,Agency_3,Sunday,39513,10592,Sports Event,0,177,50.11,72219,22243,24.51,43657,10442,42962,16429,32570.57143,9138.857143,50105,54099,59391,41709.42857
10/30/2023,3,Agency_3,Monday,41585,9124,Sports Event,1,177,50.71,72219,22243,24.5,39513,10592,36187,5550,33341.71429,9649.428571,50709,50105,41737,42991.14286
10/31/2023,3,Agency_3,Tuesday,15219,11259,Festival,1,177,26.48,72219,22243,36.19,41585,9124,25063,7466,31935.42857,10191.28571,26478,50709,32529,42126.71429
11/1/2023,3,Agency_3,Wednesday,52870,16307,Sports Event,1,177,69.18,72219,22243,13.83,15219,11259,17251,4705,37023.85714,11848.71429,69177,26478,21956,48872.57143
11/2/2023,3,Agency_3,Thursday,48410,17783,Concert,1,177,66.19,72219,22243,15.03,52870,16307,34355,16060,39031.71429,12094.85714,66193,69177,50415,51126.57143
11/3/2023,3,Agency_3,Friday,30664,9169,Concert,0,177,39.83,72219,22243,29.93,48410,17783,31968,9157,38845.42857,12096.57143,39833,66193,41125,50942
11/4/2023,3,Agency_3,Saturday,30439,9651,Sports Event,0,177,40.09,72219,22243,29.7,30664,9169,43657,10442,36957.14286,11983.57143,40090,39833,54099,48940.71429
11/5/2023,3,Agency_3,Sunday,27693,9629,None,0,177,37.32,72219,22243,31.09,30439,9651,39513,10592,35268.57143,11846,37322,40090,50105,47114.57143
11/6/2023,3,Agency_3,Monday,19302,4099,None,0,177,23.4,72219,22243,39.16,27693,9629,41585,9124,32085.28571,11128.14286,23401,37322,50709,43213.42857
11/7/2023,3,Agency_3,Tuesday,26002,8682,None,1,177,34.69,72219,22243,32.6,19302,4099,15219,11259,33625.71429,10760,34684,23401,26478,44385.71429
11/8/2023,3,Agency_3,Wednesday,19170,691,Concert,0,177,19.86,72219,22243,41.61,26002,8682,52870,16307,28811.42857,8529.142857,19861,34684,69177,37340.57143
11/9/2023,3,Agency_3,Thursday,17247,2558,None,0,177,19.8,72219,22243,41.27,19170,691,48410,17783,24359.57143,6354.142857,19805,19861,66193,30713.71429
11/10/2023,3,Agency_3,Friday,17459,4704,None,0,177,22.16,72219,22243,39.66,17247,2558,30664,9169,22473.14286,5716.285714,22163,19805,39833,28189.42857
11/11/2023,3,Agency_3,Saturday,41495,24454,Sports Event,1,177,65.95,72219,22243,13.81,17459,4704,30439,9651,24052.57143,7831,65949,22163,40090,31883.57143
11/12/2023,3,Agency_3,Sunday,33747,10192,None,1,177,43.94,72219,22243,27.67,41495,24454,27693,9629,24917.42857,7911.428571,43939,65949,37322,32828.85714
11/13/2023,3,Agency_3,Monday,34666,4627,Sports Event,0,177,39.29,72219,22243,31.11,33747,10192,19302,4099,27112.28571,7986.857143,39293,43939,23401,35099.14286
11/14/2023,3,Agency_3,Tuesday,32753,6787,None,1,177,39.54,72219,22243,30.55,34666,4627,26002,8682,28076.71429,7716.142857,39540,39293,34684,35792.85714
11/15/2023,3,Agency_3,Wednesday,23352,2856,None,0,177,26.21,72219,22243,38,32753,6787,19170,691,28674.14286,8025.428571,26208,39540,19861,36699.57143
11/16/2023,3,Agency_3,Thursday,23850,15791,Festival,1,177,39.64,72219,22243,28.7,23352,2856,17247,2558,29617.42857,9915.857143,39641,26208,19805,39533.28571
11/17/2023,3,Agency_3,Friday,28446,4473,None,1,177,32.92,72219,22243,34.33,23850,15791,17459,4704,31187,9882.857143,32919,39641,22163,41069.85714
11/18/2023,3,Agency_3,Saturday,28171,16022,Concert,0,177,44.19,72219,22243,26.38,28446,4473,41495,24454,29283.57143,8678.285714,44193,32919,65949,37961.85714
11/19/2023,3,Agency_3,Sunday,16862,10770,None,0,177,27.63,72219,22243,35.71,28171,16022,33747,10192,26871.42857,8760.857143,27632,44193,43939,35632.28571
11/20/2023,3,Agency_3,Monday,23244,10669,Concert,0,177,33.91,72219,22243,32.59,16862,10770,34666,4627,25239.71429,9624,33913,27632,39293,34863.71429
11/21/2023,3,Agency_3,Tuesday,35794,14770,Festival,1,177,50.56,72219,22243,23.44,23244,10669,32753,6787,25674.14286,10764.42857,50564,33913,39540,36438.57143
11/22/2023,3,Agency_3,Wednesday,33694,11124,Festival,1,177,44.82,72219,22243,27.05,35794,14770,23352,2856,27151.57143,11945.57143,44818,50564,26208,39097.14286
11/23/2023,3,Agency_3,Thursday,26265,4193,None,1,177,30.46,72219,22243,35.61,33694,11124,23850,15791,27496.57143,10288.71429,30458,44818,39641,37785.28571
11/24/2023,3,Agency_3,Friday,46222,9455,Sports Event,1,177,55.68,72219,22243,21.95,26265,4193,28446,4473,30036,11000.42857,55677,30458,32919,41036.42857
11/25/2023,3,Agency_3,Saturday,33942,6654,Concert,0,177,40.6,72219,22243,30.05,46222,9455,28171,16022,30860.42857,9662.142857,40596,55677,44193,40522.57143
11/26/2023,3,Agency_3,Sunday,12938,10203,Festival,0,177,23.14,72219,22243,38.07,33942,6654,16862,10770,30299.85714,9581.142857,23141,40596,27632,39881
11/27/2023,3,Agency_3,Monday,32063,6569,None,0,177,38.63,72219,22243,31.05,12938,10203,23244,10669,31559.71429,8995.428571,38632,23141,33913,40555.14286
11/28/2023,3,Agency_3,Tuesday,38810,10648,Sports Event,1,177,49.46,72219,22243,24.82,32063,6569,35794,14770,31990.57143,8406.571429,49458,38632,50564,40397.14286
11/29/2023,3,Agency_3,Wednesday,39218,14503,Sports Event,1,177,53.72,72219,22243,21.92,38810,10648,33694,11124,32779.71429,8889.285714,53721,49458,44818,41669
11/30/2023,3,Agency_3,Thursday,14095,7228,None,0,177,21.32,72219,22243,39.57,39218,14503,26265,4193,31041.14286,9322.857143,21323,53721,30458,40364
12/1/2023,3,Agency_3,Friday,35364,10941,Concert,0,177,46.31,72219,22243,26.34,14095,7228,46222,9455,29490,9535.142857,46305,21323,55677,39025.14286
12/2/2023,3,Agency_3,Saturday,51929,15590,Sports Event,1,177,67.52,72219,22243,14.8,35364,10941,33942,6654,32059.57143,10811.71429,67519,46305,40596,42871.28571
12/3/2023,3,Agency_3,Sunday,42055,13664,Festival,0,177,55.72,72219,22243,21.09,51929,15590,12938,10203,36219.14286,11306.14286,55719,67519,23141,47525.28571
12/4/2023,3,Agency_3,Monday,18229,3852,None,0,177,22.08,72219,22243,39.87,42055,13664,32063,6569,34242.85714,10918,22081,55719,38632,45160.85714
12/5/2023,3,Agency_3,Tuesday,39992,19273,Concert,1,177,59.27,72219,22243,18.19,18229,3852,38810,10648,34411.71429,12150.14286,59265,22081,49458,46561.85714
12/6/2023,3,Agency_3,Wednesday,20706,3508,Festival,0,177,24.21,72219,22243,38.87,39992,19273,39218,14503,31767.14286,10579.42857,24214,59265,53721,42346.57143
12/7/2023,3,Agency_3,Thursday,27069,7141,None,1,177,34.21,72219,22243,33.15,20706,3508,14095,7228,33620.57143,10567,34210,24214,21323,44187.57143
12/8/2023,3,Agency_3,Friday,20866,5487,None,0,177,26.35,72219,22243,37.41,27069,7141,35364,10941,31549.42857,9787.857143,26353,34210,46305,41337.28571
12/9/2023,3,Agency_3,Saturday,33989,17633,Festival,0,177,51.62,72219,22243,22.34,20866,5487,51929,15590,28986.57143,10079.71429,51622,26353,67519,39066.28571
12/10/2023,3,Agency_3,Sunday,21591,7388,Concert,0,177,28.98,72219,22243,35.71,33989,17633,42055,13664,26063.14286,9183.142857,28979,51622,55719,35246.28571
12/11/2023,3,Agency_3,Monday,29224,2912,Sports Event,0,177,32.14,72219,22243,35.03,21591,7388,18229,3852,27633.85714,9048.857143,32136,28979,22081,36682.71429
12/12/2023,3,Agency_3,Tuesday,28680,14147,Festival,0,177,42.83,72219,22243,27.44,29224,2912,39992,19273,26017.85714,8316.571429,42827,32136,59265,34334.42857
12/13/2023,3,Agency_3,Wednesday,39202,12997,Concert,1,177,52.2,72219,22243,22.98,28680,14147,20706,3508,28660.14286,9672.142857,52199,42827,24214,38332.28571
12/14/2023,3,Agency_3,Thursday,26713,8965,Festival,1,177,35.68,72219,22243,32.05,39202,12997,27069,7141,28609.28571,9932.714286,35678,52199,34210,38542
12/15/2023,3,Agency_3,Friday,27186,7418,Concert,0,177,34.6,72219,22243,32.89,26713,8965,20866,5487,29512.14286,10208.57143,34604,35678,26353,39720.71429
12/16/2023,3,Agency_3,Saturday,47534,13514,Festival,0,177,61.05,72219,22243,18.45,27186,7418,33989,17633,31447.14286,9620.142857,61048,34604,51622,41067.28571
12/17/2023,3,Agency_3,Sunday,22529,9997,None,1,177,32.53,72219,22243,33.42,47534,13514,21591,7388,31581.14286,9992.857143,32526,61048,28979,41574
12/18/2023,3,Agency_3,Monday,33736,12376,Concert,0,177,46.11,72219,22243,26.15,22529,9997,29224,2912,32225.71429,11344.85714,46112,32526,32136,43570.57143
12/19/2023,3,Agency_3,Tuesday,54408,7066,Festival,1,177,61.48,72219,22243,19.53,33736,12376,28680,14147,35901.14286,10333.28571,61474,46112,42827,46234.42857
12/20/2023,3,Agency_3,Wednesday,23917,4222,Festival,0,177,28.14,72219,22243,36.76,54408,7066,39202,12997,33717.57143,9079.714286,28139,61474,52199,42797.28571
12/21/2023,3,Agency_3,Thursday,36716,14118,Festival,1,177,50.83,72219,22243,23.44,23917,4222,26713,8965,35146.57143,9815.857143,50834,28139,35678,44962.42857
12/22/2023,3,Agency_3,Friday,37404,8241,Sports Event,0,177,45.65,72219,22243,27.21,36716,14118,27186,7418,36606.28571,9933.428571,45645,50834,34604,46539.71429
12/23/2023,3,Agency_3,Saturday,43056,16407,Festival,1,177,59.46,72219,22243,18.67,37404,8241,47534,13514,35966.57143,10346.71429,59463,45645,61048,46313.28571
12/24/2023,3,Agency_3,Sunday,28483,20285,Sports Event,0,177,48.77,72219,22243,23.24,43056,16407,22529,9997,36817.14286,11816.42857,48768,59463,32526,48633.57143
12/25/2023,3,Agency_3,Monday,17941,9127,Sports Event,0,177,27.07,72219,22243,36.32,28483,20285,33736,12376,34560.71429,11352.28571,27068,48768,46112,45913
12/26/2023,3,Agency_3,Tuesday,45177,8522,Festival,0,177,53.7,72219,22243,23.13,17941,9127,54408,7066,33242,11560.28571,53699,27068,61474,44802.28571
12/27/2023,3,Agency_3,Wednesday,19049,4285,None,0,177,23.33,72219,22243,39.16,45177,8522,23917,4222,32546.57143,11569.28571,23334,53699,28139,44115.85714
12/28/2023,3,Agency_3,Thursday,28647,13166,Festival,0,177,41.81,72219,22243,28.14,19049,4285,36716,14118,31393.85714,11433.28571,41813,23334,50834,42827.14286
12/29/2023,3,Agency_3,Friday,13410,13712,Sports Event,0,177,27.12,72219,22243,35.38,28647,13166,37404,8241,27966.14286,12214.85714,27122,41813,45645,40181
12/30/2023,3,Agency_3,Saturday,30139,13817,Sports Event,1,177,43.96,72219,22243,26.94,13410,13712,43056,16407,26120.85714,11844.85714,43956,27122,59463,37965.71429
12/31/2023,3,Agency_3,Sunday,32135,13651,Festival,0,177,45.79,72219,22243,26.06,30139,13817,28483,20285,26642.57143,10897.14286,45786,43956,48768,37539.71429
1/8/2023,4,Agency_4,Sunday,23738,10818,None,1,128,34.56,55997,10340,15.79,36812,4391,28101,18328,34581.28571,8021.428571,34556,41203,46429,42602.71429
1/9/2023,4,Agency_4,Monday,41130,9708,Sports Event,0,128,50.84,55997,10340,7.88,23738,10818,45181,3864,34002.57143,8856.285714,50838,34556,49045,42858.85714
1/10/2023,4,Agency_4,Tuesday,35946,11895,Festival,1,128,47.84,55997,10340,8.94,41130,9708,31422,6249,34648.85714,9662.857143,47841,50838,37671,44311.71429
1/11/2023,4,Agency_4,Wednesday,20620,10555,Sports Event,0,128,31.18,55997,10340,17.54,35946,11895,43151,11990,31430.14286,9457.857143,31175,47841,55141,40888
1/12/2023,4,Agency_4,Thursday,36616,6961,Concert,0,128,43.58,55997,10340,12.06,20620,10555,32744,14220,31983.28571,8420.857143,43577,31175,46964,40404.14286
1/13/2023,4,Agency_4,Friday,26473,9402,Sports Event,0,128,35.88,55997,10340,15.42,36616,6961,29021,4618,31619.28571,9104.285714,35875,43577,33639,40723.57143
1/14/2023,4,Agency_4,Saturday,41689,15058,Concert,1,128,56.75,55997,10340,3.85,26473,9402,36812,4391,32316,10628.14286,56747,35875,41203,42944.14286
1/15/2023,4,Agency_4,Sunday,71365,13938,Festival,1,128,85.3,55997,10340,-10.2,41689,15058,23738,10818,39119.85714,11073.85714,85303,56747,34556,50193.71429
1/16/2023,4,Agency_4,Monday,27312,6296,Sports Event,0,128,33.61,55997,10340,17.17,71365,13938,41130,9708,37145.85714,10586.42857,33608,85303,50838,47732.28571
1/17/2023,4,Agency_4,Tuesday,23720,4637,None,0,128,28.36,55997,10340,20.13,27312,6296,35946,11895,35399.28571,9549.571429,28357,33608,47841,44948.85714
1/18/2023,4,Agency_4,Wednesday,32668,18187,Sports Event,1,128,50.86,55997,10340,6.17,23720,4637,20620,10555,37120.42857,10639.85714,50855,28357,31175,47760.28571
1/19/2023,4,Agency_4,Thursday,52841,9041,Sports Event,1,128,61.88,55997,10340,2.49,32668,18187,36616,6961,39438.28571,10937,61882,50855,43577,50375.28571
1/20/2023,4,Agency_4,Friday,16000,11925,Sports Event,0,128,27.93,55997,10340,18.89,52841,9041,26473,9402,37942.14286,11297.42857,27925,61882,35875,49239.57143
1/21/2023,4,Agency_4,Saturday,38787,20361,Festival,1,128,59.15,55997,10340,1.59,16000,11925,41689,15058,37527.57143,12055,59148,27925,56747,49582.57143
1/22/2023,4,Agency_4,Sunday,23748,20992,Concert,1,128,44.74,55997,10340,8.67,38787,20361,71365,13938,30725.14286,13062.71429,44740,59148,85303,43787.85714
1/23/2023,4,Agency_4,Monday,27190,15377,Concert,1,128,42.57,55997,10340,10.88,23748,20992,27312,6296,30707.71429,14360,42567,44740,33608,45067.71429
1/24/2023,4,Agency_4,Tuesday,20071,3092,None,0,128,23.16,55997,10340,23.04,27190,15377,23720,4637,30186.42857,14139.28571,23163,42567,28357,44325.71429
1/25/2023,4,Agency_4,Wednesday,26946,10832,Festival,0,128,37.78,55997,10340,14.18,20071,3092,32668,18187,29369,13088.57143,37778,23163,50855,42457.57143
1/26/2023,4,Agency_4,Thursday,40031,14679,Sports Event,1,128,54.71,55997,10340,4.94,26946,10832,52841,9041,27539,13894,54710,37778,61882,41433
1/27/2023,4,Agency_4,Friday,58269,4452,Sports Event,1,128,62.72,55997,10340,2.98,40031,14679,16000,11925,33577.42857,12826.42857,62721,54710,27925,46403.85714
1/28/2023,4,Agency_4,Saturday,65721,16113,Sports Event,1,128,81.83,55997,10340,-8.9,58269,4452,38787,20361,37425.14286,12219.57143,81834,62721,59148,49644.71429
1/29/2023,4,Agency_4,Sunday,27910,5169,Sports Event,0,128,33.08,55997,10340,17.66,65721,16113,23748,20992,38019.71429,9959.142857,33079,81834,44740,47978.85714
1/30/2023,4,Agency_4,Monday,37155,16286,Festival,1,128,53.44,55997,10340,5.26,27910,5169,27190,15377,39443.28571,10089,53441,33079,42567,49532.28571
1/31/2023,4,Agency_4,Tuesday,37755,19092,Concert,1,128,56.85,55997,10340,2.99,37155,16286,20071,3092,41969.57143,12374.71429,56847,53441,23163,54344.28571
2/1/2023,4,Agency_4,Wednesday,19116,8457,Festival,0,128,27.57,55997,10340,19.76,37755,19092,26946,10832,40851,12035.42857,27573,56847,37778,52886.42857
2/2/2023,4,Agency_4,Thursday,26789,13630,Sports Event,1,128,40.42,55997,10340,12.3,19116,8457,40031,14679,38959.28571,11885.57143,40419,27573,54710,50844.85714
2/3/2023,4,Agency_4,Friday,47646,9896,Festival,1,128,57.54,55997,10340,4.49,26789,13630,58269,4452,37441.71429,12663.28571,57542,40419,62721,50105
2/4/2023,4,Agency_4,Saturday,16328,16698,Concert,1,128,33.03,55997,10340,15.38,47646,9896,65721,16113,30385.57143,12746.85714,33026,57542,81834,43132.42857
2/5/2023,4,Agency_4,Sunday,51908,17969,Sports Event,1,128,69.88,55997,10340,-3.3,16328,16698,27910,5169,33813.85714,14575.42857,69877,33026,33079,48389.28571
2/6/2023,4,Agency_4,Monday,51047,6799,Sports Event,1,128,57.85,55997,10340,4.95,51908,17969,37155,16286,35798.42857,13220.14286,57846,69877,53441,49018.57143
2/7/2023,4,Agency_4,Tuesday,23401,7385,None,0,128,30.79,55997,10340,18.37,51047,6799,37755,19092,33747.85714,11547.71429,30786,57846,56847,45295.57143
2/8/2023,4,Agency_4,Wednesday,16660,9586,Concert,0,128,26.25,55997,10340,20.2,23401,7385,19116,8457,33397,11709,26246,30786,27573,45106
2/9/2023,4,Agency_4,Thursday,26218,8221,Sports Event,0,128,34.44,55997,10340,16.37,16660,9586,26789,13630,33315.42857,10936.28571,34439,26246,40419,44251.71429
2/10/2023,4,Agency_4,Friday,42389,9579,Sports Event,1,128,51.97,55997,10340,7.34,26218,8221,47646,9896,32564.42857,10891,51968,34439,57542,43455.42857
2/11/2023,4,Agency_4,Saturday,25928,9223,None,1,128,35.15,55997,10340,15.82,42389,9579,16328,16698,33935.85714,9823.142857,35151,51968,33026,43759
2/12/2023,4,Agency_4,Sunday,26213,6249,Sports Event,0,128,32.46,55997,10340,17.75,25928,9223,51908,17969,30265.14286,8148.857143,32462,35151,69877,38414
2/13/2023,4,Agency_4,Monday,35094,4593,Festival,0,128,39.69,55997,10340,14.47,26213,6249,51047,6799,27986.14286,7833.714286,39687,32462,57846,35819.85714
2/14/2023,4,Agency_4,Tuesday,34996,10072,Festival,0,128,45.07,55997,10340,10.69,35094,4593,23401,7385,29642.57143,8217.571429,45068,39687,30786,37860.14286
2/15/2023,4,Agency_4,Wednesday,22171,8672,Sports Event,1,128,30.84,55997,10340,18.08,34996,10072,16660,9586,30429.85714,8087,30843,45068,26246,38516.85714
2/16/2023,4,Agency_4,Thursday,33761,4251,None,1,128,38.01,55997,10340,15.38,22171,8672,26218,8221,31507.42857,7519.857143,38012,30843,34439,39027.28571
2/17/2023,4,Agency_4,Friday,34470,14099,Sports Event,1,128,48.57,55997,10340,8.13,33761,4251,42389,9579,30376.14286,8165.571429,48569,38012,51968,38541.71429
2/18/2023,4,Agency_4,Saturday,43048,9936,Sports Event,0,128,52.98,55997,10340,6.76,34470,14099,25928,9223,32821.85714,8267.428571,52984,48569,35151,41089.28571
2/19/2023,4,Agency_4,Sunday,30621,17335,Festival,0,128,47.96,55997,10340,7.79,43048,9936,26213,6249,33451.57143,9851.142857,47956,52984,32462,43302.71429
2/20/2023,4,Agency_4,Monday,28694,6957,None,0,128,35.65,55997,10340,16.02,30621,17335,35094,4593,32537.28571,10188.85714,35651,47956,39687,42726.14286
2/21/2023,4,Agency_4,Tuesday,30639,5751,Festival,0,128,36.39,55997,10340,15.89,28694,6957,34996,10072,31914.85714,9571.571429,36390,35651,45068,41486.42857
2/22/2023,4,Agency_4,Wednesday,20601,8463,None,1,128,29.06,55997,10340,19.01,30639,5751,22171,8672,31690.57143,9541.714286,29064,36390,30843,41232.28571
2/23/2023,4,Agency_4,Thursday,43077,18571,Festival,1,128,61.65,55997,10340,0.7,20601,8463,33761,4251,33021.42857,11587.42857,61648,29064,38012,44608.85714
2/24/2023,4,Agency_4,Friday,23252,1993,None,0,128,25.25,55997,10340,22.22,43077,18571,34470,14099,31418.85714,9858,25245,61648,48569,41276.85714
2/25/2023,4,Agency_4,Saturday,39404,5465,None,1,128,44.87,55997,10340,11.71,23252,1993,43048,9936,30898.28571,9219.285714,44869,25245,52984,40117.57143
2/26/2023,4,Agency_4,Sunday,32544,12155,Concert,0,128,44.7,55997,10340,10.46,39404,5465,30621,17335,31173,8479.285714,44699,44869,47956,39652.28571
2/27/2023,4,Agency_4,Monday,58457,26701,Sports Event,1,128,85.16,55997,10340,-12.68,32544,12155,28694,6957,35424.85714,11299.85714,85158,44699,35651,46724.71429
2/28/2023,4,Agency_4,Tuesday,44914,11026,Sports Event,1,128,55.94,55997,10340,5.06,58457,26701,30639,5751,37464.14286,12053.42857,55940,85158,36390,49517.57143
3/1/2023,4,Agency_4,Wednesday,44210,16124,Concert,1,128,60.33,55997,10340,1.84,44914,11026,20601,8463,40836.85714,13147.85714,60334,55940,29064,53984.71429
3/2/2023,4,Agency_4,Thursday,23914,12026,None,1,128,35.94,55997,10340,14.86,44210,16124,43077,18571,38099.28571,12212.85714,35940,60334,61648,50312.14286
3/3/2023,4,Agency_4,Friday,27495,8393,None,1,128,35.89,55997,10340,15.61,23914,12026,23252,1993,38705.42857,13127.14286,35888,35940,25245,51832.57143
3/4/2023,4,Agency_4,Saturday,41992,12913,Sports Event,0,128,54.91,55997,10340,5.2,27495,8393,39404,5465,39075.14286,14191.14286,54905,35888,44869,53266.28571
3/5/2023,4,Agency_4,Sunday,29032,4894,None,0,128,33.93,55997,10340,17.29,41992,12913,32544,12155,38573.42857,13153.85714,33926,54905,44699,51727.28571
3/6/2023,4,Agency_4,Monday,33555,6661,Festival,1,128,40.22,55997,10340,13.8,29032,4894,58457,26701,35016,10291,40216,33926,85158,45307
3/7/2023,4,Agency_4,Tuesday,43284,15605,Festival,1,128,58.89,55997,10340,2.67,33555,6661,44914,11026,34783.14286,10945.14286,58889,40216,55940,45728.28571
3/8/2023,4,Agency_4,Wednesday,43461,19868,Concert,1,128,63.33,55997,10340,-0.4,43284,15605,44210,16124,34676.14286,11480,63329,58889,60334,46156.14286
3/9/2023,4,Agency_4,Thursday,38945,15082,Festival,1,128,54.03,55997,10340,5.21,43461,19868,23914,12026,36823.42857,11916.57143,54027,63329,35940,48740
3/10/2023,4,Agency_4,Friday,18903,5915,None,1,128,24.82,55997,10340,21.64,38945,15082,27495,8393,35596,11562.57143,24818,54027,35888,47158.57143
3/11/2023,4,Agency_4,Saturday,54936,20723,Sports Event,1,128,75.66,55997,10340,-6.74,18903,5915,41992,12913,37445.14286,12678.28571,75659,24818,54905,50123.42857
3/12/2023,4,Agency_4,Sunday,28906,8837,None,1,128,37.74,55997,10340,14.6,54936,20723,29032,4894,37427.14286,13241.57143,37743,75659,33926,50668.71429
3/13/2023,4,Agency_4,Monday,12410,4285,None,0,128,16.7,55997,10340,26.03,28906,8837,33555,6661,34406.42857,12902.14286,16695,37743,40216,47308.57143
3/14/2023,4,Agency_4,Tuesday,31786,8610,None,1,128,40.4,55997,10340,13.32,12410,4285,43284,15605,32763.85714,11902.85714,40396,16695,58889,44666.71429
3/15/2023,4,Agency_4,Wednesday,22503,5099,None,0,128,27.6,55997,10340,20.42,31786,8610,43461,19868,29769.85714,9793,27602,40396,63329,39562.85714
3/16/2023,4,Agency_4,Thursday,30052,6254,Concert,0,128,36.31,55997,10340,15.83,22503,5099,38945,15082,28499.42857,8531.857143,36306,27602,54027,37031.28571
3/17/2023,4,Agency_4,Friday,45813,13901,Concert,1,128,59.71,55997,10340,2.6,30052,6254,18903,5915,32343.71429,9672.714286,59714,36306,24818,42016.42857
3/18/2023,4,Agency_4,Saturday,52556,12212,Sports Event,1,128,64.77,55997,10340,0.41,45813,13901,54936,20723,32003.71429,8456.857143,64768,59714,75659,40460.57143
3/19/2023,4,Agency_4,Sunday,21605,22258,Concert,1,128,43.86,55997,10340,8.85,52556,12212,28906,8837,30960.71429,10374.14286,43863,64768,37743,41334.85714
3/20/2023,4,Agency_4,Monday,26407,5565,Concert,0,128,31.97,55997,10340,18.14,21605,22258,12410,4285,32960.28571,10557,31972,43863,16695,43517.28571
3/21/2023,4,Agency_4,Tuesday,45760,10031,Sports Event,1,128,55.79,55997,10340,5.33,26407,5565,31786,8610,34956.57143,10760,55791,31972,40396,45716.57143
3/22/2023,4,Agency_4,Wednesday,25299,6234,None,0,128,31.53,55997,10340,18.22,45760,10031,22503,5099,35356,10922.14286,31533,55791,27602,46278.14286
3/23/2023,4,Agency_4,Thursday,45663,5397,Sports Event,1,128,51.06,55997,10340,8.63,25299,6234,30052,6254,37586.14286,10799.71429,51060,31533,36306,48385.85714
3/24/2023,4,Agency_4,Friday,39088,9387,Sports Event,0,128,48.48,55997,10340,9.12,45663,5397,45813,13901,36625.42857,10154.85714,48475,51060,59714,46780.28571
3/25/2023,4,Agency_4,Saturday,32675,11682,Concert,0,128,44.36,55997,10340,10.72,39088,9387,52556,12212,33785.28571,10079.14286,44357,48475,64768,43864.42857
3/26/2023,4,Agency_4,Sunday,20012,12855,Festival,0,128,32.87,55997,10340,16.23,32675,11682,21605,22258,33557.71429,8735.857143,32867,44357,43863,42293.57143
3/27/2023,4,Agency_4,Monday,14853,2294,None,0,128,17.15,55997,10340,26.2,20012,12855,26407,5565,31907.14286,8268.571429,17147,32867,31972,40175.71429
3/28/2023,4,Agency_4,Tuesday,24156,17195,Festival,1,128,41.35,55997,10340,11.12,14853,2294,45760,10031,28820.85714,9292,41351,17147,55791,38112.85714
3/29/2023,4,Agency_4,Wednesday,32863,19199,Concert,1,128,52.06,55997,10340,5.37,24156,17195,25299,6234,29901.42857,11144.14286,52062,41351,31533,41045.57143
3/30/2023,4,Agency_4,Thursday,22516,2219,None,1,128,24.73,55997,10340,22.43,32863,19199,45663,5397,26594.71429,10690.14286,24735,52062,51060,37284.85714
3/31/2023,4,Agency_4,Friday,28113,17780,Sports Event,1,128,45.89,55997,10340,8.73,22516,2219,39088,9387,25026.85714,11889.14286,45893,24735,48475,36916
4/1/2023,4,Agency_4,Saturday,44974,12075,Sports Event,1,128,57.05,55997,10340,4.3,28113,17780,32675,11682,26783.85714,11945.28571,57049,45893,44357,38729.14286
4/2/2023,4,Agency_4,Sunday,32448,10925,None,1,128,43.37,55997,10340,11.36,44974,12075,20012,12855,28560.42857,11669.57143,43373,57049,32867,40230
4/3/2023,4,Agency_4,Monday,49892,18792,Festival,1,128,68.69,55997,10340,-2.86,32448,10925,14853,2294,33566,14026.42857,68684,43373,17147,47592.42857
4/4/2023,4,Agency_4,Tuesday,35491,5585,Concert,1,128,41.08,55997,10340,13.58,49892,18792,24156,17195,35185.28571,12367.85714,41076,68684,41351,47553.14286
4/5/2023,4,Agency_4,Wednesday,17932,5520,None,0,128,23.45,55997,10340,22.41,35491,5585,32863,19199,33052.28571,10413.71429,23452,41076,52062,43466
4/6/2023,4,Agency_4,Thursday,22771,5244,Festival,0,128,28.02,55997,10340,20.18,17932,5520,22516,2219,33088.71429,10845.85714,28015,23452,24735,43934.57143
4/7/2023,4,Agency_4,Friday,42350,11666,Concert,1,128,54.02,55997,10340,5.89,22771,5244,28113,17780,35122.57143,9972.428571,54016,28015,45893,45095
4/8/2023,4,Agency_4,Saturday,24195,4527,None,0,128,28.72,55997,10340,19.97,42350,11666,44974,12075,32154.14286,8894.142857,28722,54016,57049,41048.28571
4/9/2023,4,Agency_4,Sunday,33924,6963,Festival,0,128,40.89,55997,10340,13.4,24195,4527,32448,10925,32365,8328.142857,40887,28722,43373,40693.14286
4/10/2023,4,Agency_4,Monday,47677,16826,Sports Event,1,128,64.5,55997,10340,-0.38,33924,6963,49892,18792,32048.57143,8047.285714,64503,40887,68684,40095.85714
4/11/2023,4,Agency_4,Tuesday,20999,7473,Concert,1,128,28.47,55997,10340,19.51,47677,16826,35491,5585,29978.28571,8317,28472,64503,41076,38295.28571
4/12/2023,4,Agency_4,Wednesday,18775,6288,Sports Event,0,128,25.06,55997,10340,21.45,20999,7473,17932,5520,30098.71429,8426.714286,25063,28472,23452,38525.42857
4/13/2023,4,Agency_4,Thursday,29373,3570,Sports Event,0,128,32.94,55997,10340,18.05,18775,6288,22771,5244,31041.85714,8187.571429,32943,25063,28015,39229.42857
4/14/2023,4,Agency_4,Friday,30010,7120,Concert,1,128,37.13,55997,10340,15.25,29373,3570,42350,11666,29279,7538.142857,37130,32943,54016,36817.14286
4/15/2023,4,Agency_4,Saturday,37864,11354,Festival,0,128,49.22,55997,10340,8.36,30010,7120,24195,4527,31231.71429,8513.428571,49218,37130,28722,39745.14286
4/16/2023,4,Agency_4,Sunday,38354,16562,Concert,1,128,54.92,55997,10340,4.47,37864,11354,33924,6963,31864.57143,9884.714286,54916,49218,40887,41749.28571
4/17/2023,4,Agency_4,Monday,25899,7575,Sports Event,0,128,33.47,55997,10340,16.98,38354,16562,47677,16826,28753.42857,8563.142857,33474,54916,64503,37316.57143
4/18/2023,4,Agency_4,Tuesday,42550,13056,Festival,0,128,55.61,55997,10340,4.82,25899,7575,20999,7473,31832.14286,9360.714286,55606,33474,28472,41192.85714
4/19/2023,4,Agency_4,Wednesday,20253,11320,Sports Event,0,128,31.57,55997,10340,17.19,42550,13056,18775,6288,32043.28571,10079.57143,31573,55606,25063,42122.85714
4/20/2023,4,Agency_4,Thursday,46909,6433,Concert,1,128,53.34,55997,10340,7.28,20253,11320,29373,3570,34548.42857,10488.57143,53342,31573,32943,45037
4/21/2023,4,Agency_4,Friday,46981,19218,Sports Event,1,128,66.2,55997,10340,-1.71,46909,6433,30010,7120,36972.85714,12216.85714,66199,53342,37130,49189.71429
4/22/2023,4,Agency_4,Saturday,33665,9789,Sports Event,1,128,43.45,55997,10340,11.55,46981,19218,37864,11354,36373,11993.28571,43454,66199,49218,48366.28571
4/23/2023,4,Agency_4,Sunday,58705,17146,Sports Event,1,128,75.85,55997,10340,-6.12,33665,9789,38354,16562,39280.28571,12076.71429,75851,43454,54916,51357
4/24/2023,4,Agency_4,Monday,34135,9657,Concert,0,128,43.79,55997,10340,11.41,58705,17146,25899,7575,40456.85714,12374.14286,43792,75851,33474,52831
4/25/2023,4,Agency_4,Tuesday,21953,2347,None,0,128,24.3,55997,10340,22.62,34135,9657,42550,13056,37514.42857,10844.28571,24300,43792,55606,48358.71429
4/26/2023,4,Agency_4,Wednesday,37854,12476,Festival,0,128,50.33,55997,10340,7.58,21953,2347,20253,11320,40028.85714,11009.42857,50330,24300,31573,51038.28571
4/27/2023,4,Agency_4,Thursday,28279,8352,Festival,0,128,36.63,55997,10340,15.25,37854,12476,46909,6433,37367.42857,11283.57143,36631,50330,53342,48651
4/28/2023,4,Agency_4,Friday,18516,10247,Festival,0,128,28.76,55997,10340,18.81,28279,8352,46981,19218,33301,10002,28763,36631,66199,43303
4/29/2023,4,Agency_4,Saturday,53492,15083,Sports Event,1,128,68.58,55997,10340,-2.07,18516,10247,33665,9789,36133.42857,10758.28571,68575,28763,43454,46891.71429
4/30/2023,4,Agency_4,Sunday,30745,5630,None,0,128,36.38,55997,10340,15.92,53492,15083,58705,17146,32139.14286,9113.142857,36375,68575,75851,41252.28571
5/1/2023,4,Agency_4,Monday,44504,7044,Festival,1,128,51.55,55997,10340,8.05,30745,5630,34135,9657,33620.42857,8739.857143,51548,36375,43792,42360.28571
5/2/2023,4,Agency_4,Tuesday,25846,6511,None,1,128,32.36,55997,10340,17.76,44504,7044,21953,2347,34176.57143,9334.714286,32357,51548,24300,43511.28571
5/3/2023,4,Agency_4,Wednesday,41195,10138,Concert,1,128,51.33,55997,10340,7.54,25846,6511,37854,12476,34653.85714,9000.714286,51333,32357,50330,43654.57143
5/4/2023,4,Agency_4,Thursday,19342,6652,None,0,128,25.99,55997,10340,20.91,41195,10138,28279,8352,33377.14286,8757.857143,25994,51333,36631,42135
5/5/2023,4,Agency_4,Friday,26724,3036,Festival,0,128,29.76,55997,10340,19.75,19342,6652,18516,10247,34549.71429,7727.714286,29760,25994,28763,42277.42857
5/6/2023,4,Agency_4,Saturday,67267,24015,Sports Event,1,128,91.28,55997,10340,-15.21,26724,3036,53492,15083,36517.57143,9003.714286,91282,29760,68575,45521.28571
5/7/2023,4,Agency_4,Sunday,24368,14097,Festival,0,128,38.47,55997,10340,13.18,67267,24015,30745,5630,35606.57143,10213.28571,38465,91282,36375,45819.85714
5/8/2023,4,Agency_4,Monday,26227,9394,Sports Event,0,128,35.62,55997,10340,15.55,24368,14097,44504,7044,32995.57143,10549,35621,38465,51548,43544.57143
5/9/2023,4,Agency_4,Tuesday,32206,7702,Concert,0,128,39.91,55997,10340,13.74,26227,9394,25846,6511,33904.14286,10719.14286,39908,35621,32357,44623.28571
5/10/2023,4,Agency_4,Wednesday,31357,8610,Festival,1,128,39.97,55997,10340,13.53,32206,7702,41195,10138,32498.71429,10500.85714,39967,39908,51333,42999.57143
5/11/2023,4,Agency_4,Thursday,23128,5671,Concert,0,128,28.8,55997,10340,19.7,31357,8610,19342,6652,33039.57143,10360.71429,28799,39967,25994,43400.28571
5/12/2023,4,Agency_4,Friday,29496,6065,Concert,0,128,35.56,55997,10340,16.24,23128,5671,26724,3036,33435.57143,10793.42857,35561,28799,29760,44229
5/13/2023,4,Agency_4,Saturday,36519,14512,None,1,128,51.03,55997,10340,6.82,29496,6065,67267,24015,29043,9435.857143,51031,35561,91282,38478.85714
5/14/2023,4,Agency_4,Sunday,30778,12106,Festival,0,128,42.88,55997,10340,11.37,36519,14512,24368,14097,29958.71429,9151.428571,42884,51031,38465,39110.14286
5/15/2023,4,Agency_4,Monday,43871,14146,Festival,1,128,58.02,55997,10340,3.4,30778,12106,26227,9394,32479.28571,9830.285714,58017,42884,35621,42309.57143
5/16/2023,4,Agency_4,Tuesday,39739,15434,Festival,1,128,55.17,55997,10340,4.56,43871,14146,32206,7702,33555.42857,10934.85714,55173,58017,39908,44490.28571
5/17/2023,4,Agency_4,Wednesday,22411,2524,None,0,128,24.94,55997,10340,22.26,39739,15434,31357,8610,32277.42857,10065.42857,24935,55173,39967,42342.85714
5/18/2023,4,Agency_4,Thursday,36517,11515,Sports Event,0,128,48.03,55997,10340,8.92,22411,2524,23128,5671,34190.14286,10900.28571,48032,24935,28799,45090.42857
5/19/2023,4,Agency_4,Friday,24274,8627,Festival,0,128,32.9,55997,10340,17.06,36517,11515,29496,6065,33444.14286,11266.28571,32901,48032,35561,44710.42857
5/20/2023,4,Agency_4,Saturday,42148,10124,Concert,0,128,52.27,55997,10340,7.08,24274,8627,36519,14512,34248.28571,10639.42857,52272,32901,51031,44887.71429
5/21/2023,4,Agency_4,Sunday,59351,30095,Concert,1,128,89.45,55997,10340,-15.51,42148,10124,30778,12106,38330.14286,13209.28571,89446,52272,42884,51539.42857
5/22/2023,4,Agency_4,Monday,31336,5324,Concert,1,128,36.66,55997,10340,15.84,59351,30095,43871,14146,36539.42857,11949,36660,89446,58017,48488.42857
5/23/2023,4,Agency_4,Tuesday,32278,10953,Sports Event,0,128,43.23,55997,10340,11.43,31336,5324,39739,15434,35473.57143,11308.85714,43231,36660,55173,46782.42857
5/24/2023,4,Agency_4,Wednesday,36747,18816,Festival,1,128,55.56,55997,10340,3.69,32278,10953,22411,2524,37521.57143,13636.28571,55563,43231,24935,51157.85714
5/25/2023,4,Agency_4,Thursday,25946,15196,Sports Event,1,128,41.14,55997,10340,11.63,36747,18816,36517,11515,36011.42857,14162.14286,41142,55563,48032,50173.57143
5/26/2023,4,Agency_4,Friday,16970,8438,None,0,128,25.41,55997,10340,20.84,25946,15196,24274,8627,34968,14135.14286,25408,41142,32901,49103.14286
5/27/2023,4,Agency_4,Saturday,70111,10723,Sports Event,1,128,80.83,55997,10340,-7.33,16970,8438,42148,10124,38962.71429,14220.71429,80834,25408,52272,53183.42857
5/28/2023,4,Agency_4,Sunday,40369,20788,Festival,1,128,61.16,55997,10340,0.5,70111,10723,59351,30095,36251,12891.14286,61157,80834,89446,49142.14286
5/29/2023,4,Agency_4,Monday,35224,11683,Sports Event,1,128,46.91,55997,10340,9.45,40369,20788,31336,5324,36806.42857,13799.57143,46907,61157,36660,50606
5/30/2023,4,Agency_4,Tuesday,20126,1160,None,0,128,21.29,55997,10340,24.36,35224,11683,32278,10953,35070.42857,12400.57143,21286,46907,43231,47471
5/31/2023,4,Agency_4,Wednesday,38863,8615,Sports Event,1,128,47.48,55997,10340,9.77,20126,1160,36747,18816,35372.71429,10943.28571,47478,21286,55563,46316
6/1/2023,4,Agency_4,Thursday,22794,11041,None,1,128,33.84,55997,10340,16.11,38863,8615,25946,15196,34922.42857,10349.71429,33835,47478,41142,45272.14286
6/2/2023,4,Agency_4,Friday,26748,15769,Concert,1,128,42.52,55997,10340,10.82,22794,11041,16970,8438,36319.28571,11397,42517,33835,25408,47716.28571
6/3/2023,4,Agency_4,Saturday,43535,13737,Concert,1,128,57.27,55997,10340,3.85,26748,15769,70111,10723,32522.71429,11827.57143,57272,42517,80834,44350.28571
6/4/2023,4,Agency_4,Sunday,56045,17573,Festival,1,128,73.62,55997,10340,-5.09,43535,13737,40369,20788,34762.14286,11368.28571,73618,57272,61157,46130.42857
6/5/2023,4,Agency_4,Monday,44563,16507,Festival,1,128,61.07,55997,10340,1.4,56045,17573,35224,11683,36096.28571,12057.42857,61070,73618,46907,48153.71429
6/6/2023,4,Agency_4,Tuesday,35768,8984,Concert,1,128,44.75,55997,10340,11.06,44563,16507,20126,1160,38330.85714,13175.14286,44752,61070,21286,51506
6/7/2023,4,Agency_4,Wednesday,21861,5693,Festival,0,128,27.55,55997,10340,20.32,35768,8984,38863,8615,35902,12757.71429,27554,44752,47478,48659.71429
6/8/2023,4,Agency_4,Thursday,34745,7489,None,0,128,42.23,55997,10340,12.62,21861,5693,22794,11041,37609.28571,12250.28571,42234,27554,33835,49859.57143
6/9/2023,4,Agency_4,Friday,19866,4003,Sports Event,0,128,23.87,55997,10340,22.5,34745,7489,26748,15769,36626.14286,10569.42857,23869,42234,42517,47195.57143
6/10/2023,4,Agency_4,Saturday,26890,7922,None,0,128,34.81,55997,10340,16.25,19866,4003,43535,13737,34248.28571,9738.714286,34812,23869,57272,43987
6/11/2023,4,Agency_4,Sunday,53220,13892,Sports Event,1,128,67.11,55997,10340,-1.1,26890,7922,56045,17573,33844.71429,9212.857143,67112,34812,73618,43057.57143
6/12/2023,4,Agency_4,Monday,25183,7916,None,1,128,33.1,55997,10340,17.1,53220,13892,44563,16507,31076.14286,7985.571429,33099,67112,61070,39061.71429
6/13/2023,4,Agency_4,Tuesday,30643,953,Concert,0,128,31.6,55997,10340,19.25,25183,7916,35768,8984,30344,6838.285714,31596,33099,44752,37182.28571
6/14/2023,4,Agency_4,Wednesday,28276,5604,Festival,0,128,33.88,55997,10340,17.17,30643,953,21861,5693,31260.42857,6825.571429,33880,31596,27554,38086
6/15/2023,4,Agency_4,Thursday,31314,18649,Festival,0,128,49.96,55997,10340,6.53,28276,5604,34745,7489,30770.28571,8419.857143,49963,33880,42234,39190.14286
6/16/2023,4,Agency_4,Friday,42582,10405,Festival,1,128,52.99,55997,10340,6.66,31314,18649,19866,4003,34015.42857,9334.428571,52987,49963,23869,43349.85714
6/17/2023,4,Agency_4,Saturday,38390,10856,None,1,128,49.25,55997,10340,8.44,42582,10405,26890,7922,35658.28571,9753.571429,49246,52987,34812,45411.85714
6/18/2023,4,Agency_4,Sunday,39780,13730,Concert,0,128,53.51,55997,10340,5.73,38390,10856,53220,13892,33738.28571,9730.428571,53510,49246,67112,43468.71429
6/19/2023,4,Agency_4,Monday,59049,6516,Sports Event,1,128,65.57,55997,10340,1.15,39780,13730,25183,7916,38576.28571,9530.428571,65565,53510,33099,48106.71429
6/20/2023,4,Agency_4,Tuesday,43617,7489,Concert,1,128,51.11,55997,10340,8.18,59049,6516,30643,953,40429.71429,10464.14286,51106,65565,31596,50893.85714
6/21/2023,4,Agency_4,Wednesday,22777,3162,None,0,128,25.94,55997,10340,21.63,43617,7489,28276,5604,39644.14286,10115.28571,25939,51106,33880,49759.42857
6/22/2023,4,Agency_4,Thursday,17913,4409,None,0,128,22.32,55997,10340,23.19,22777,3162,31314,18649,37729.71429,8081,22322,25939,49963,45810.71429
6/23/2023,4,Agency_4,Friday,37318,11621,Sports Event,0,128,48.94,55997,10340,8.44,17913,4409,42582,10405,36977.71429,8254.714286,48939,22322,52987,45232.42857
6/24/2023,4,Agency_4,Saturday,24787,11290,Concert,0,128,36.08,55997,10340,14.94,37318,11621,38390,10856,35034.42857,8316.714286,36077,48939,49246,43351.14286
6/25/2023,4,Agency_4,Sunday,29613,5485,Sports Event,0,128,35.1,55997,10340,16.59,24787,11290,39780,13730,33582,7138.857143,35098,36077,53510,40720.85714
6/26/2023,4,Agency_4,Monday,24588,6136,None,1,128,30.72,55997,10340,18.65,29613,5485,59049,6516,28659,7084.571429,30724,35098,65565,35743.57143
6/27/2023,4,Agency_4,Tuesday,41772,8211,None,1,128,49.98,55997,10340,8.6,24588,6136,43617,7489,28395.42857,7187.714286,49983,30724,51106,35583.14286
6/28/2023,4,Agency_4,Wednesday,25566,9210,Concert,1,128,34.78,55997,10340,16.01,41772,8211,22777,3162,28793.85714,8051.714286,34776,49983,25939,36845.57143
6/29/2023,4,Agency_4,Thursday,25106,9176,None,0,128,34.28,55997,10340,16.26,25566,9210,17913,4409,29821.42857,8732.714286,34282,34776,22322,38554.14286
6/30/2023,4,Agency_4,Friday,18105,2108,Sports Event,0,128,20.21,55997,10340,24.71,25106,9176,37318,11621,27076.71429,7373.714286,20213,34282,48939,34450.42857
7/1/2023,4,Agency_4,Saturday,35224,7512,None,0,128,42.74,55997,10340,12.37,18105,2108,24787,11290,28567.71429,6834,42736,20213,36077,35401.71429
7/2/2023,4,Agency_4,Sunday,36639,18777,Festival,1,128,55.42,55997,10340,3.77,35224,7512,29613,5485,29571.42857,8732.857143,55416,42736,35098,38304.28571
7/3/2023,4,Agency_4,Monday,10231,8510,Festival,0,128,18.74,55997,10340,24.16,36639,18777,24588,6136,27520.42857,9072,18741,55416,30724,36592.42857
7/4/2023,4,Agency_4,Tuesday,32458,11641,Sports Event,0,128,44.1,55997,10340,10.86,10231,8510,41772,8211,26189.85714,9562,44099,18741,49983,35751.85714
7/5/2023,4,Agency_4,Wednesday,22395,8790,Concert,0,128,31.19,55997,10340,17.89,32458,11641,25566,9210,25736.85714,9502,31185,44099,34776,35238.85714
7/6/2023,4,Agency_4,Thursday,15372,5510,None,0,128,20.88,55997,10340,23.69,22395,8790,25106,9176,24346.28571,8978.285714,20882,31185,34282,33324.57143
7/7/2023,4,Agency_4,Friday,30269,9955,Sports Event,1,128,40.23,55997,10340,13.13,15372,5510,18105,2108,26084,10099.28571,40224,20882,20213,36183.28571
7/8/2023,4,Agency_4,Saturday,27036,13927,Concert,0,128,40.96,55997,10340,11.97,30269,9955,35224,7512,24914.28571,11015.71429,40963,40224,42736,35930
7/9/2023,4,Agency_4,Sunday,56843,14015,Sports Event,1,128,70.86,55997,10340,-3,27036,13927,36639,18777,27800.57143,10335.42857,70858,40963,55416,38136
7/10/2023,4,Agency_4,Monday,30286,3573,Concert,0,128,33.86,55997,10340,17.59,56843,14015,10231,8510,30665.57143,9630.142857,33859,70858,18741,40295.71429
7/11/2023,4,Agency_4,Tuesday,18501,4899,None,0,128,23.4,55997,10340,22.56,30286,3573,32458,11641,28671.71429,8667,23400,33859,44099,37338.71429
7/12/2023,4,Agency_4,Wednesday,43033,3886,None,1,128,46.92,55997,10340,11,18501,4899,22395,8790,31620,7966.428571,46919,23400,31185,39586.42857
7/13/2023,4,Agency_4,Thursday,53274,16643,Festival,1,128,69.92,55997,10340,-3.05,43033,3886,15372,5510,37034.57143,9556.857143,69917,46919,20882,46591.42857
7/14/2023,4,Agency_4,Friday,32104,14478,Festival,0,128,46.58,55997,10340,9.05,53274,16643,30269,9955,37296.71429,10203,46582,69917,40224,47499.71429
7/15/2023,4,Agency_4,Saturday,51152,17877,Concert,1,128,69.03,55997,10340,-2.85,32104,14478,27036,13927,40741.85714,10767.28571,69029,46582,40963,51509.14286
7/16/2023,4,Agency_4,Sunday,23680,9681,None,0,128,33.36,55997,10340,16.62,51152,17877,56843,14015,36004.28571,10148.14286,33361,69029,70858,46152.42857
7/17/2023,4,Agency_4,Monday,38223,6371,Festival,0,128,44.59,55997,10340,11.66,23680,9681,30286,3573,37138.14286,10547.85714,44594,33361,33859,47686
7/18/2023,4,Agency_4,Tuesday,20104,7809,Festival,0,128,27.91,55997,10340,19.72,38223,6371,18501,4899,37367.14286,10963.57143,27913,44594,23400,48330.71429
7/19/2023,4,Agency_4,Wednesday,31198,11595,Concert,1,128,42.79,55997,10340,11.52,20104,7809,43033,3886,35676.42857,12064.85714,42793,27913,46919,47741.28571
7/20/2023,4,Agency_4,Thursday,39280,6944,Festival,0,128,46.23,55997,10340,10.74,31198,11595,53274,16643,33677.28571,10679.28571,46224,42793,69917,44356.57143
7/21/2023,4,Agency_4,Friday,38580,12176,Concert,1,128,50.76,55997,10340,7.42,39280,6944,32104,14478,34602.42857,10350.42857,50756,46224,46582,44952.85714
7/22/2023,4,Agency_4,Saturday,43635,1118,Sports Event,0,128,44.75,55997,10340,12.64,38580,12176,51152,17877,33528.57143,7956.285714,44753,50756,69029,41484.85714
7/23/2023,4,Agency_4,Sunday,39700,16775,Concert,1,128,56.48,55997,10340,3.64,43635,1118,23680,9681,35817.14286,8969.714286,56475,44753,33361,44786.85714
7/24/2023,4,Agency_4,Monday,26000,4016,None,0,128,30.02,55997,10340,19.43,39700,16775,38223,6371,34071,8633.285714,30016,56475,44594,42704.28571
7/25/2023,4,Agency_4,Tuesday,20703,14848,Festival,1,128,35.55,55997,10340,14.49,26000,4016,20104,7809,34156.57143,9638.857143,35551,30016,27913,43795.42857
7/26/2023,4,Agency_4,Wednesday,32804,6235,Concert,1,128,39.04,55997,10340,14.47,20703,14848,31198,11595,34386,8873.142857,39039,35551,42793,43259.14286
7/27/2023,4,Agency_4,Thursday,32912,11019,Sports Event,1,128,43.93,55997,10340,11.07,32804,6235,39280,6944,33476.28571,9455.285714,43931,39039,46224,42931.57143
7/28/2023,4,Agency_4,Friday,33103,1399,Concert,1,128,34.5,55997,10340,17.71,32912,11019,38580,12176,32693.85714,7915.714286,34502,43931,50756,40609.57143
7/29/2023,4,Agency_4,Saturday,29382,9813,None,0,128,39.2,55997,10340,13.68,33103,1399,43635,1118,30657.71429,9157.857143,39195,34502,44753,39815.57143
7/30/2023,4,Agency_4,Sunday,27908,3541,None,0,128,31.45,55997,10340,18.8,29382,9813,39700,16775,28973.14286,7267.285714,31449,39195,56475,36240.42857
7/31/2023,4,Agency_4,Monday,28488,8476,Festival,0,128,36.96,55997,10340,15.06,27908,3541,26000,4016,29328.57143,7904.428571,36964,31449,30016,37233
8/1/2023,4,Agency_4,Tuesday,22993,6336,None,0,128,29.33,55997,10340,19.3,28488,8476,20703,14848,29655.71429,6688.428571,29329,36964,35551,36344.14286
8/2/2023,4,Agency_4,Wednesday,31841,12287,Sports Event,1,128,44.13,55997,10340,10.71,22993,6336,32804,6235,29518.14286,7553,44128,29329,39039,37071.14286
8/3/2023,4,Agency_4,Thursday,43457,18828,Sports Event,1,128,62.29,55997,10340,0.33,31841,12287,32912,11019,31024.57143,8668.571429,62285,44128,43931,39693.14286
8/4/2023,4,Agency_4,Friday,35283,11182,Sports Event,0,128,46.47,55997,10340,9.77,43457,18828,33103,1399,31336,10066.14286,46465,62285,34502,41402.14286
8/5/2023,4,Agency_4,Saturday,47780,24195,Concert,1,128,71.98,55997,10340,-5.59,35283,11182,29382,9813,33964.28571,12120.71429,71975,46465,39195,46085
8/6/2023,4,Agency_4,Sunday,34394,5964,None,1,128,40.36,55997,10340,13.86,47780,24195,27908,3541,34890.85714,12466.85714,40358,71975,31449,47357.71429
8/7/2023,4,Agency_4,Monday,27016,6395,None,0,128,33.41,55997,10340,17.25,34394,5964,28488,8476,34680.57143,12169.57143,33411,40358,36964,46850.14286
8/8/2023,4,Agency_4,Tuesday,34678,9617,Concert,1,128,44.3,55997,10340,11.16,27016,6395,22993,6336,36349.85714,12638.28571,44295,33411,29329,48988.14286
8/9/2023,4,Agency_4,Wednesday,32223,10074,Sports Event,0,128,42.3,55997,10340,12.07,34678,9617,31841,12287,36404.42857,12322.14286,42297,44295,44128,48726.57143
8/10/2023,4,Agency_4,Thursday,40922,13380,Festival,1,128,54.3,55997,10340,5.41,32223,10074,43457,18828,36042.28571,11543.85714,54302,42297,62285,47586.14286
8/11/2023,4,Agency_4,Friday,42748,12143,Concert,0,128,54.89,55997,10340,5.36,40922,13380,35283,11182,37108.71429,11681.14286,54891,54302,46465,48789.85714
8/12/2023,4,Agency_4,Saturday,37715,15209,Concert,0,128,52.92,55997,10340,5.73,42748,12143,47780,24195,35670.85714,10397.42857,52924,54891,71975,46068.28571
8/13/2023,4,Agency_4,Sunday,26706,12806,Sports Event,0,128,39.51,55997,10340,12.92,37715,15209,34394,5964,34572.57143,11374.85714,39512,52924,40358,45947.42857
8/14/2023,4,Agency_4,Monday,43569,7757,Sports Event,0,128,51.33,55997,10340,8.02,26706,12806,27016,6395,36937.28571,11569.42857,51326,39512,33411,48506.71429
8/15/2023,4,Agency_4,Tuesday,23641,6281,Festival,0,128,29.92,55997,10340,19.02,43569,7757,34678,9617,35360.57143,11092.85714,29922,51326,44295,46453.42857
8/16/2023,4,Agency_4,Wednesday,14551,3430,None,0,128,17.98,55997,10340,25.56,23641,6281,32223,10074,32836,10143.71429,17981,29922,42297,42979.71429
8/17/2023,4,Agency_4,Thursday,27220,3719,Concert,0,128,30.94,55997,10340,19.02,14551,3430,40922,13380,30878.57143,8763.571429,30939,17981,54302,39642.14286
8/18/2023,4,Agency_4,Friday,39152,16193,Concert,1,128,55.35,55997,10340,4.32,27220,3719,42748,12143,30364.85714,9342.142857,55345,30939,54891,39707
8/19/2023,4,Agency_4,Saturday,36178,24869,Festival,1,128,61.05,55997,10340,-0.26,39152,16193,37715,15209,30145.28571,10722.14286,61047,55345,52924,40867.42857
8/20/2023,4,Agency_4,Sunday,52774,21846,Concert,1,128,74.62,55997,10340,-6.44,36178,24869,26706,12806,33869.28571,12013.57143,74620,61047,39512,45882.85714
8/21/2023,4,Agency_4,Monday,32584,15967,Concert,1,128,48.55,55997,10340,7.77,52774,21846,43569,7757,32300,13186.42857,48551,74620,51326,45486.42857
8/22/2023,4,Agency_4,Tuesday,14540,6780,None,0,128,21.32,55997,10340,23.22,32584,15967,23641,6281,30999.85714,13257.71429,21320,48551,29922,44257.57143
8/23/2023,4,Agency_4,Wednesday,40675,14532,Festival,1,128,55.21,55997,10340,4.73,14540,6780,14551,3430,34731.85714,14843.71429,55207,21320,17981,49575.57143
8/24/2023,4,Agency_4,Thursday,21183,5455,Festival,0,128,26.64,55997,10340,20.83,40675,14532,27220,3719,33869.42857,15091.71429,26638,55207,30939,48961.14286
8/25/2023,4,Agency_4,Friday,34479,5275,Festival,0,128,39.75,55997,10340,14.3,21183,5455,39152,16193,33201.85714,13532,39754,26638,55345,46733.85714
8/26/2023,4,Agency_4,Saturday,52219,7007,Sports Event,1,128,59.23,55997,10340,4.22,34479,5275,36178,24869,35493.42857,10980.28571,59226,39754,61047,46473.71429
8/27/2023,4,Agency_4,Sunday,43632,5600,Festival,0,128,49.23,55997,10340,9.5,52219,7007,52774,21846,34187.42857,8659.428571,49232,59226,74620,42846.85714
8/28/2023,4,Agency_4,Monday,34141,10626,Sports Event,0,128,44.77,55997,10340,10.73,43632,5600,32584,15967,34409.85714,7896.428571,44767,49232,48551,42306.28571
8/29/2023,4,Agency_4,Tuesday,24774,10478,Festival,0,128,35.25,55997,10340,15.51,34141,10626,14540,6780,35871.85714,8424.714286,35252,44767,21320,44296.57143
8/30/2023,4,Agency_4,Wednesday,31953,6667,Festival,0,128,38.62,55997,10340,14.59,24774,10478,40675,14532,34625.85714,7301.142857,38620,35252,55207,41927
8/31/2023,4,Agency_4,Thursday,14957,1074,None,0,128,16.03,55997,10340,27.01,31953,6667,21183,5455,33736.42857,6675.285714,16031,38620,26638,40411.71429
9/1/2023,4,Agency_4,Friday,21748,1870,None,0,128,23.62,55997,10340,23.05,14957,1074,34479,5275,31917.71429,6188.857143,23618,16031,39754,38106.57143
9/2/2023,4,Agency_4,Saturday,24571,5814,None,0,128,30.39,55997,10340,18.88,21748,1870,52219,7007,27968,6018.428571,30385,23618,59226,33986.42857
9/3/2023,4,Agency_4,Sunday,36496,7998,None,1,128,44.5,55997,10340,11.39,24571,5814,43632,5600,26948.57143,6361,44494,30385,49232,33309.57143
9/4/2023,4,Agency_4,Monday,35786,15381,Festival,1,128,51.17,55997,10340,6.58,36496,7998,34141,10626,27183.57143,7040.285714,51167,44494,44767,34223.85714
9/5/2023,4,Agency_4,Tuesday,32512,9574,Concert,0,128,42.09,55997,10340,12.28,35786,15381,24774,10478,28289,6911.142857,42086,51167,35252,35200.14286
9/6/2023,4,Agency_4,Wednesday,29049,2699,None,1,128,31.75,55997,10340,18.82,32512,9574,31953,6667,27874.14286,6344.285714,31748,42086,38620,34218.42857
9/7/2023,4,Agency_4,Thursday,46376,14813,Concert,1,128,61.19,55997,10340,1.68,29049,2699,14957,1074,32362.57143,8307,61189,31748,16031,40669.57143
9/8/2023,4,Agency_4,Friday,29086,10736,Concert,1,128,39.82,55997,10340,13.18,46376,14813,21748,1870,33410.85714,9573.571429,39822,61189,23618,42984.42857
9/9/2023,4,Agency_4,Saturday,46339,14637,Festival,1,128,60.98,55997,10340,1.82,29086,10736,24571,5814,36520.57143,10834,60976,39822,30385,47354.57143
9/10/2023,4,Agency_4,Sunday,33803,14308,None,1,128,48.11,55997,10340,8.32,46339,14637,36496,7998,36135.85714,11735.42857,48111,60976,44494,47871.28571
9/11/2023,4,Agency_4,Monday,25408,2375,None,0,128,27.78,55997,10340,20.87,33803,14308,35786,15381,34653.28571,9877.428571,27783,48111,51167,44530.71429
9/12/2023,4,Agency_4,Tuesday,34665,13016,Concert,0,128,47.68,55997,10340,8.79,25408,2375,32512,9574,34960.85714,10369.14286,47681,27783,42086,45330
9/13/2023,4,Agency_4,Wednesday,28514,10053,None,1,128,38.57,55997,10340,13.94,34665,13016,29049,2699,34884.42857,11419.71429,38567,47681,31748,46304.14286
9/14/2023,4,Agency_4,Thursday,39079,9865,None,1,128,48.95,55997,10340,8.79,28514,10053,46376,14813,33842,10712.85714,48944,38567,61189,44554.85714
9/15/2023,4,Agency_4,Friday,41429,16874,Festival,1,128,58.3,55997,10340,2.71,39079,9865,29086,10736,35605.28571,11589.71429,58303,48944,39822,47195
9/16/2023,4,Agency_4,Saturday,37303,11153,Festival,0,128,48.46,55997,10340,8.78,41429,16874,46339,14637,34314.42857,11092,48456,58303,60976,45406.42857
9/17/2023,4,Agency_4,Sunday,32835,17958,Sports Event,0,128,50.79,55997,10340,6.25,37303,11153,33803,14308,34176.14286,11613.42857,50793,48456,48111,45789.57143
9/18/2023,4,Agency_4,Monday,23860,13708,Festival,0,128,37.57,55997,10340,13.71,32835,17958,25408,2375,33955,13232.42857,37568,50793,27783,47187.42857
9/19/2023,4,Agency_4,Tuesday,43873,5238,Festival,1,128,49.11,55997,10340,9.63,23860,13708,34665,13016,35270.42857,12121.28571,49111,37568,47681,47391.71429
9/20/2023,4,Agency_4,Wednesday,42584,1901,Concert,1,128,44.49,55997,10340,12.61,43873,5238,28514,10053,37280.42857,10956.71429,44485,49111,38567,48237.14286
9/21/2023,4,Agency_4,Thursday,45097,16112,Festival,1,128,61.21,55997,10340,1.41,42584,1901,39079,9865,38140.14286,11849.14286,61209,44485,48944,49989.28571
9/22/2023,4,Agency_4,Friday,25557,8919,Concert,0,128,34.48,55997,10340,16.21,45097,16112,41429,16874,35872.71429,10712.71429,34476,61209,58303,46585.42857
9/23/2023,4,Agency_4,Saturday,53586,8813,Concert,0,128,62.4,55997,10340,2.27,25557,8919,37303,11153,38198.85714,10378.42857,62399,34476,48456,48577.28571
9/24/2023,4,Agency_4,Sunday,26469,17598,Sports Event,0,128,44.07,55997,10340,9.68,53586,8813,32835,17958,37289.42857,10327,44067,62399,50793,47616.42857
9/25/2023,4,Agency_4,Monday,58133,11916,Concert,1,128,70.05,55997,10340,-2.17,26469,17598,23860,13708,42185.57143,10071,70049,44067,37568,52256.57143
9/26/2023,4,Agency_4,Tuesday,32574,10754,None,1,128,43.33,55997,10340,11.42,58133,11916,43873,5238,40571.42857,10859,43328,70049,49111,51430.42857
9/27/2023,4,Agency_4,Wednesday,21173,5640,None,1,128,26.81,55997,10340,20.7,32574,10754,42584,1901,37512.71429,11393.14286,26813,43328,44485,48905.85714
9/28/2023,4,Agency_4,Thursday,39231,14229,Festival,0,128,53.46,55997,10340,5.66,21173,5640,45097,16112,36674.71429,11124.14286,53460,26813,61209,47798.85714
9/29/2023,4,Agency_4,Friday,34221,5508,Concert,0,128,39.73,55997,10340,14.27,39231,14229,25557,8919,37912.42857,10636.85714,39729,53460,34476,48549.28571
9/30/2023,4,Agency_4,Saturday,70047,12184,Sports Event,1,128,82.23,55997,10340,-8.32,34221,5508,53586,8813,40264,11118.42857,82231,39729,62399,51382.42857
10/1/2023,4,Agency_4,Sunday,21988,7389,None,0,128,29.38,55997,10340,19.07,70047,12184,26469,17598,39623.85714,9660,29377,82231,44067,49283.85714
10/2/2023,4,Agency_4,Monday,41655,11401,Festival,0,128,53.06,55997,10340,6.43,21988,7389,58133,11916,37269.85714,9586.428571,53056,29377,70049,46856.28571
10/3/2023,4,Agency_4,Tuesday,22074,5926,None,0,128,28,55997,10340,20.05,41655,11401,32574,10754,35769.85714,8896.714286,28000,53056,43328,44666.57143
10/4/2023,4,Agency_4,Wednesday,39423,14556,Sports Event,1,128,53.98,55997,10340,5.34,22074,5926,21173,5640,38377,10170.42857,53979,28000,26813,48547.42857
10/5/2023,4,Agency_4,Thursday,11028,7490,Sports Event,0,128,18.52,55997,10340,24.48,39423,14556,39231,14229,34348,9207.714286,18518,53979,53460,43555.71429
10/6/2023,4,Agency_4,Friday,21206,2697,None,0,128,23.9,55997,10340,22.75,11028,7490,34221,5508,32488.71429,8806.142857,23903,18518,39729,41294.85714
10/7/2023,4,Agency_4,Saturday,39475,10146,Sports Event,0,128,49.62,55997,10340,8.4,21206,2697,70047,12184,28121.28571,8515,49621,23903,82231,36636.28571
10/8/2023,4,Agency_4,Sunday,44892,14825,None,1,128,59.72,55997,10340,2.41,39475,10146,21988,7389,31393.28571,9577.285714,59717,49621,29377,40970.57143
10/9/2023,4,Agency_4,Monday,26505,7986,Concert,0,128,34.49,55997,10340,16.39,44892,14825,41655,11401,29229,9089.428571,34491,59717,53056,38318.42857
10/10/2023,4,Agency_4,Tuesday,38278,9748,Festival,1,128,48.03,55997,10340,9.27,26505,7986,22074,5926,31543.85714,9635.428571,48026,34491,28000,41179.28571
10/11/2023,4,Agency_4,Wednesday,40901,8289,Festival,1,128,49.19,55997,10340,8.98,38278,9748,39423,14556,31755,8740.142857,49190,48026,53979,40495.14286
10/12/2023,4,Agency_4,Thursday,27974,14863,Festival,1,128,42.84,55997,10340,10.84,40901,8289,11028,7490,34175.85714,9793.428571,42837,49190,18518,43969.28571
10/13/2023,4,Agency_4,Friday,45136,8070,Sports Event,1,128,53.21,55997,10340,7.02,27974,14863,21206,2697,37594.42857,10561,53206,42837,23903,48155.42857
10/14/2023,4,Agency_4,Saturday,44056,8256,Concert,0,128,52.31,55997,10340,7.43,45136,8070,39475,10146,38248.85714,10291,52312,53206,49621,48539.85714
10/15/2023,4,Agency_4,Sunday,38277,14674,Concert,0,128,52.95,55997,10340,5.83,44056,8256,44892,14825,37303.85714,10269.42857,52951,52312,59717,47573.28571
10/16/2023,4,Agency_4,Monday,19831,5909,None,0,128,25.74,55997,10340,21.18,38277,14674,26505,7986,36350.42857,9972.714286,25740,52951,34491,46323.14286
10/17/2023,4,Agency_4,Tuesday,17417,4607,None,0,128,22.02,55997,10340,23.3,19831,5909,38278,9748,33370.28571,9238.285714,22024,25740,48026,42608.57143
10/18/2023,4,Agency_4,Wednesday,36991,8344,Sports Event,1,128,45.34,55997,10340,10.9,17417,4607,40901,8289,32811.71429,9246.142857,45335,22024,49190,42057.85714
10/19/2023,4,Agency_4,Thursday,37276,4526,Festival,1,128,41.8,55997,10340,13.43,36991,8344,27974,14863,34140.57143,7769.428571,41802,45335,42837,41910
10/20/2023,4,Agency_4,Friday,22807,6202,None,1,128,29.01,55997,10340,19.49,37276,4526,45136,8070,30950.71429,7502.571429,29009,41802,53206,38453.28571
10/21/2023,4,Agency_4,Saturday,43802,13975,Concert,1,128,57.78,55997,10340,3.55,22807,6202,44056,8256,30914.42857,8319.571429,57777,29009,52312,39234
10/22/2023,4,Agency_4,Sunday,46076,18434,Festival,1,128,64.51,55997,10340,-0.71,43802,13975,38277,14674,32028.57143,8856.714286,64510,57777,52951,40885.28571
10/23/2023,4,Agency_4,Monday,36558,6290,Festival,0,128,42.85,55997,10340,12.55,46076,18434,19831,5909,34418.14286,8911.142857,42848,64510,25740,43329.28571
10/24/2023,4,Agency_4,Tuesday,13983,2915,None,0,128,16.9,55997,10340,26.2,36558,6290,17417,4607,33927.57143,8669.428571,16898,42848,22024,42597
10/25/2023,4,Agency_4,Wednesday,26344,7303,Festival,0,128,33.65,55997,10340,16.95,13983,2915,36991,8344,32406.57143,8520.714286,33647,16898,45335,40927.28571
10/26/2023,4,Agency_4,Thursday,31492,5728,Concert,1,128,37.22,55997,10340,15.48,26344,7303,37276,4526,31580.28571,8692.428571,37220,33647,41802,40272.71429
10/27/2023,4,Agency_4,Friday,26578,9115,Concert,0,128,35.69,55997,10340,15.57,31492,5728,22807,6202,32119,9108.571429,35693,37220,29009,41227.57143
10/28/2023,4,Agency_4,Saturday,53761,12020,Concert,1,128,65.78,55997,10340,-0.06,26578,9115,43802,13975,33541.71429,8829.285714,65781,35693,57777,42371
10/29/2023,4,Agency_4,Sunday,32283,6952,Sports Event,0,128,39.24,55997,10340,14.23,53761,12020,46076,18434,31571.28571,7189,39235,65781,64510,38760.28571
10/30/2023,4,Agency_4,Monday,38691,7861,Festival,1,128,46.55,55997,10340,10.39,32283,6952,36558,6290,31876,7413.428571,46552,39235,42848,39289.42857
10/31/2023,4,Agency_4,Tuesday,34297,2427,Concert,0,128,36.73,55997,10340,16.39,38691,7861,13983,2915,34778,7343.714286,36724,46552,16898,42121.71429
11/1/2023,4,Agency_4,Wednesday,35491,13332,Sports Event,1,128,48.82,55997,10340,8.16,34297,2427,26344,7303,36084.71429,8205,48823,36724,33647,44289.71429
11/2/2023,4,Agency_4,Thursday,31378,17656,Concert,0,128,49.03,55997,10340,7.19,35491,13332,31492,5728,36068.42857,9909,49034,48823,37220,45977.42857
11/3/2023,4,Agency_4,Friday,32623,5084,Sports Event,0,128,37.71,55997,10340,15.37,31378,17656,26578,9115,36932,9333.142857,37707,49034,35693,46265.14286
11/4/2023,4,Agency_4,Saturday,35139,3197,Concert,0,128,38.34,55997,10340,15.43,32623,5084,53761,12020,34271.71429,8072.714286,38336,37707,65781,42344.42857
11/5/2023,4,Agency_4,Sunday,23516,4332,None,0,128,27.85,55997,10340,20.45,35139,3197,32283,6952,33019.28571,7698.428571,27848,38336,39235,40717.71429
11/6/2023,4,Agency_4,Monday,36864,6630,Concert,0,128,43.49,55997,10340,12.16,23516,4332,38691,7861,32758.28571,7522.571429,43494,27848,46552,40280.85714
11/7/2023,4,Agency_4,Tuesday,37861,8872,Concert,1,128,46.73,55997,10340,10.1,36864,6630,34297,2427,33267.42857,8443.285714,46733,43494,36724,41710.71429
11/8/2023,4,Agency_4,Wednesday,43041,7406,Festival,0,128,50.45,55997,10340,8.53,37861,8872,35491,13332,34346,7596.714286,50447,46733,48823,41942.71429
11/9/2023,4,Agency_4,Thursday,43743,11267,Festival,0,128,55.01,55997,10340,5.48,43041,7406,31378,17656,36112.42857,6684,55010,50447,49034,42796.42857
11/10/2023,4,Agency_4,Friday,22410,5737,None,0,128,28.15,55997,10340,20.02,43743,11267,32623,5084,34653.42857,6777.285714,28147,55010,37707,41430.71429
11/11/2023,4,Agency_4,Saturday,51405,3539,Concert,1,128,54.94,55997,10340,7.06,22410,5737,35139,3197,36977.14286,6826.142857,54944,28147,38336,43803.28571
11/12/2023,4,Agency_4,Sunday,33489,14784,Concert,0,128,48.27,55997,10340,8.14,51405,3539,23516,4332,38401.85714,8319.285714,48273,54944,27848,46721.14286
11/13/2023,4,Agency_4,Monday,29632,3721,Festival,0,128,33.35,55997,10340,17.82,33489,14784,36864,6630,37368.71429,7903.714286,33353,48273,43494,45272.42857
11/14/2023,4,Agency_4,Tuesday,25658,11771,None,1,128,37.43,55997,10340,14.17,29632,3721,37861,8872,35625.42857,8317.857143,37429,33353,46733,43943.28571
11/15/2023,4,Agency_4,Wednesday,26234,4875,None,0,128,31.11,55997,10340,18.71,25658,11771,43041,7406,33224.42857,7956.285714,31109,37429,50447,41180.71429
11/16/2023,4,Agency_4,Thursday,48276,10153,Sports Event,1,128,58.43,55997,10340,3.99,26234,4875,43743,11267,33872,7797.142857,58429,31109,55010,41669.14286
11/17/2023,4,Agency_4,Friday,17220,5356,Sports Event,0,128,22.58,55997,10340,22.88,48276,10153,22410,5737,33130.57143,7742.714286,22576,58429,28147,40873.28571
11/18/2023,4,Agency_4,Saturday,65084,13774,Sports Event,1,128,78.86,55997,10340,-6.95,17220,5356,51405,3539,35084.71429,9204.857143,78858,22576,54944,44289.57143
11/19/2023,4,Agency_4,Sunday,43952,13613,Concert,1,128,57.57,55997,10340,3.73,65084,13774,33489,14784,36579.42857,9037.571429,57565,78858,48273,45617
11/20/2023,4,Agency_4,Monday,44280,14026,Concert,0,128,58.31,55997,10340,3.28,43952,13613,29632,3721,38672,10509.71429,58306,57565,33353,49181.71429
11/21/2023,4,Agency_4,Tuesday,60631,11140,Festival,1,128,71.77,55997,10340,-2.88,44280,14026,25658,11771,43668.14286,10419.57143,71771,58306,37429,54087.71429
11/22/2023,4,Agency_4,Wednesday,32217,3342,Sports Event,0,128,35.56,55997,10340,16.79,60631,11140,26234,4875,44522.85714,10200.57143,35559,71771,31109,54723.42857
11/23/2023,4,Agency_4,Thursday,27384,2664,None,0,128,30.05,55997,10340,19.68,32217,3342,48276,10153,41538.28571,9130.714286,30048,35559,58429,50669
11/24/2023,4,Agency_4,Friday,41111,6675,Festival,1,128,47.79,55997,10340,10.01,27384,2664,17220,5356,44951.28571,9319.142857,47786,30048,22576,54270.42857
11/25/2023,4,Agency_4,Saturday,39908,10287,Sports Event,1,128,50.2,55997,10340,8.08,41111,6675,65084,13774,41354.71429,8821,50195,47786,78858,50175.71429
11/26/2023,4,Agency_4,Sunday,20352,5097,None,0,128,25.45,55997,10340,21.49,39908,10287,43952,13613,37983.28571,7604.428571,25449,50195,57565,45587.71429
11/27/2023,4,Agency_4,Monday,33653,15865,Festival,1,128,49.52,55997,10340,7.3,20352,5097,44280,14026,36465.14286,7867.142857,49518,25449,58306,44332.28571
11/28/2023,4,Agency_4,Tuesday,28226,12949,Concert,1,128,41.18,55997,10340,12.06,33653,15865,60631,11140,31835.85714,8125.571429,41175,49518,71771,39961.42857
11/29/2023,4,Agency_4,Wednesday,39133,6754,Concert,0,128,45.89,55997,10340,10.94,28226,12949,32217,3342,32823.85714,8613,45887,41175,35559,41436.85714
11/30/2023,4,Agency_4,Thursday,21333,6353,None,1,128,27.69,55997,10340,20.12,39133,6754,27384,2664,31959.42857,9140,27686,45887,30048,41099.42857
12/1/2023,4,Agency_4,Friday,50501,12823,Festival,1,128,63.32,55997,10340,1.01,21333,6353,41111,6675,33300.85714,10018.28571,63324,27686,47786,43319.14286
12/2/2023,4,Agency_4,Saturday,40582,18461,Sports Event,1,128,59.04,55997,10340,2.02,50501,12823,39908,10287,33397.14286,11186,59043,63324,50195,44583.14286
12/3/2023,4,Agency_4,Sunday,33901,19684,Festival,1,128,53.59,55997,10340,4.51,40582,18461,20352,5097,35332.71429,13269.85714,53585,59043,25449,48602.57143
12/4/2023,4,Agency_4,Monday,33064,7452,Festival,0,128,40.52,55997,10340,13.49,33901,19684,33653,15865,35248.57143,12068,40516,53585,49518,47316.57143
12/5/2023,4,Agency_4,Tuesday,20549,4516,None,1,128,25.07,55997,10340,21.8,33064,7452,28226,12949,34151.85714,10863.28571,25065,40516,41175,45015.14286
12/6/2023,4,Agency_4,Wednesday,34011,12676,Concert,0,128,46.69,55997,10340,9.36,20549,4516,39133,6754,33420.14286,11709.28571,46687,25065,45887,45129.42857
12/7/2023,4,Agency_4,Thursday,25219,10057,Festival,0,128,35.28,55997,10340,15.59,34011,12676,21333,6353,33975.28571,12238.42857,35276,46687,27686,46213.71429
12/8/2023,4,Agency_4,Friday,18649,9115,Sports Event,1,128,27.77,55997,10340,19.53,25219,10057,50501,12823,29425,11708.71429,27764,35276,63324,41133.71429
12/9/2023,4,Agency_4,Saturday,35719,7027,Concert,0,128,42.75,55997,10340,12.46,18649,9115,40582,18461,28730.28571,10075.28571,42746,27764,59043,38805.57143
12/10/2023,4,Agency_4,Sunday,18380,4763,None,0,128,23.14,55997,10340,22.71,35719,7027,33901,19684,26513,7943.714286,23143,42746,53585,34456.71429
12/11/2023,4,Agency_4,Monday,41847,11007,Concert,1,128,52.85,55997,10340,6.61,18380,4763,33064,7452,27767.71429,8451.571429,52854,23143,40516,36219.28571
12/12/2023,4,Agency_4,Tuesday,8808,758,None,0,128,9.57,55997,10340,30.3,41847,11007,20549,4516,26090.42857,7914.714286,9566,52854,25065,34005.14286
12/13/2023,4,Agency_4,Wednesday,33081,14077,Sports Event,1,128,47.16,55997,10340,8.84,8808,758,34011,12676,25957.57143,8114.857143,47158,9566,46687,34072.42857
12/14/2023,4,Agency_4,Thursday,9393,6800,Concert,0,128,16.19,55997,10340,25.78,33081,14077,25219,10057,23696.71429,7649.571429,16193,47158,35276,31346.28571
12/15/2023,4,Agency_4,Friday,33867,18506,Concert,1,128,52.37,55997,10340,5.35,9393,6800,18649,9115,25870.71429,8991.142857,52373,16193,27764,34861.85714
12/16/2023,4,Agency_4,Saturday,32533,12740,Festival,0,128,45.27,55997,10340,10.05,33867,18506,35719,7027,25415.57143,9807.285714,45273,52373,42746,35222.85714
12/17/2023,4,Agency_4,Sunday,37270,1630,Festival,0,128,38.9,55997,10340,15.46,32533,12740,18380,4763,28114.14286,9359.714286,38900,45273,23143,37473.85714
12/18/2023,4,Agency_4,Monday,46489,12923,Concert,1,128,59.41,55997,10340,2.95,37270,1630,41847,11007,28777.28571,9633.428571,59412,38900,52854,38410.71429
12/19/2023,4,Agency_4,Tuesday,33811,21848,Festival,0,128,55.66,55997,10340,3.04,46489,12923,8808,758,32349.14286,12646.28571,55659,59412,9566,44995.42857
12/20/2023,4,Agency_4,Wednesday,14368,14363,Sports Event,0,128,28.73,55997,10340,18,33811,21848,33081,14077,29675.85714,12687.14286,28731,55659,47158,42363
12/21/2023,4,Agency_4,Thursday,18562,5574,None,0,128,24.14,55997,10340,22.05,14368,14363,9393,6800,30985.71429,12512,24136,28731,16193,43497.71429
12/22/2023,4,Agency_4,Friday,29658,7056,Concert,0,128,36.71,55997,10340,15.47,18562,5574,33867,18506,30384.42857,10876.28571,36714,24136,52373,41260.71429
12/23/2023,4,Agency_4,Saturday,26754,10299,None,1,128,37.05,55997,10340,14.65,29658,7056,32533,12740,29558.85714,10527.57143,37053,36714,45273,40086.42857
12/24/2023,4,Agency_4,Sunday,19365,11831,None,1,128,31.2,55997,10340,17.27,26754,10299,37270,1630,27001,11984.85714,31196,37053,38900,38985.85714
12/25/2023,4,Agency_4,Monday,26878,4656,Concert,0,128,31.53,55997,10340,18.54,19365,11831,46489,12923,24199.42857,10803.85714,31534,31196,59412,35003.28571
12/26/2023,4,Agency_4,Tuesday,26623,12773,Festival,0,128,39.4,55997,10340,12.98,26878,4656,33811,21848,23172.57143,9507.428571,39396,31534,55659,32680
12/27/2023,4,Agency_4,Wednesday,25984,9717,Festival,0,128,35.7,55997,10340,15.44,26623,12773,14368,14363,24832,8843.714286,35701,39396,28731,33675.71429
12/28/2023,4,Agency_4,Thursday,16345,6515,None,0,128,22.86,55997,10340,22.5,25984,9717,18562,5574,24515.28571,8978.142857,22860,35701,24136,33493.42857
12/29/2023,4,Agency_4,Friday,35140,14784,Concert,0,128,49.93,55997,10340,7.32,16345,6515,29658,7056,25298.42857,10082.14286,49924,22860,36714,35380.57143
12/30/2023,4,Agency_4,Saturday,34419,14004,Festival,0,128,48.42,55997,10340,8.22,35140,14784,26754,10299,26393.42857,10611.42857,48423,49924,37053,37004.85714
12/31/2023,4,Agency_4,Sunday,47946,23486,Festival,1,128,71.43,55997,10340,-5.18,34419,14004,19365,11831,30476.42857,12276.42857,71432,48423,31196,42752.85714
1/8/2023,5,Agency_5,Sunday,43884,17558,Concert,0,136,61.44,88405,16621,21.6,36394,21379,38387,20080,38163.42857,13017.57143,61442,57773,58467,51181
1/9/2023,5,Agency_5,Monday,22074,6356,None,1,136,28.43,88405,16621,40.35,43884,17558,28539,8280,37239.85714,12742.71429,28430,61442,36819,49982.57143
1/10/2023,5,Agency_5,Tuesday,11802,4215,None,0,136,16.02,88405,16621,46.99,22074,6356,39893,13099,33226.85714,11473.57143,16017,28430,52992,44700.42857
1/11/2023,5,Agency_5,Wednesday,37473,6913,Festival,0,136,44.39,88405,16621,32.26,11802,4215,29127,9229,34419.14286,11142.71429,44386,16017,38356,45561.85714
1/12/2023,5,Agency_5,Thursday,30162,6465,None,1,136,36.63,88405,16621,36.23,37473,6913,41835,11849,32751.57143,10373.57143,36627,44386,53684,43125.14286
1/13/2023,5,Agency_5,Friday,42159,6435,Concert,1,136,48.59,88405,16621,30.25,30162,6465,47472,9729,31992.57143,9903,48594,36627,57201,41895.57143
1/14/2023,5,Agency_5,Saturday,24511,0,None,0,136,24.51,88405,16621,43.58,42159,6435,36394,21379,30295,6848.857143,24511,48594,57773,37143.85714
1/15/2023,5,Agency_5,Sunday,44612,5380,Festival,1,136,49.99,88405,16621,29.76,24511,0,43884,17558,30399,5109.142857,49992,24511,61442,35508.14286
1/16/2023,5,Agency_5,Monday,39043,11141,Concert,0,136,50.19,88405,16621,28.52,44612,5380,22074,6356,32823.14286,5792.714286,50184,49992,28430,38615.85714
1/17/2023,5,Agency_5,Tuesday,43549,19139,Festival,1,136,62.69,88405,16621,20.66,39043,11141,11802,4215,37358.42857,7924.714286,62688,50184,16017,45283.14286
1/18/2023,5,Agency_5,Wednesday,19831,11891,None,1,136,31.72,88405,16621,37.6,43549,19139,37473,6913,34838.14286,8635.857143,31722,62688,44386,43474
1/19/2023,5,Agency_5,Thursday,36990,7694,Concert,0,136,44.68,88405,16621,31.96,19831,11891,30162,6465,35813.57143,8811.428571,44684,31722,36627,44625
1/20/2023,5,Agency_5,Friday,33381,3901,None,1,136,37.28,88405,16621,36.42,36990,7694,42159,6435,34559.57143,8449.428571,37282,44684,48594,43009
1/21/2023,5,Agency_5,Saturday,28578,8358,Festival,0,136,36.94,88405,16621,35.7,33381,3901,24511,0,35140.57143,9643.428571,36936,37282,24511,44784
1/22/2023,5,Agency_5,Sunday,20826,3751,None,0,136,24.58,88405,16621,42.8,28578,8358,44612,5380,31742.57143,9410.714286,24577,36936,49992,41153.28571
1/23/2023,5,Agency_5,Monday,50924,10667,Sports Event,1,136,61.59,88405,16621,22.91,20826,3751,39043,11141,33439.85714,9343,61591,24577,50184,42782.85714
1/24/2023,5,Agency_5,Tuesday,32643,6560,Sports Event,0,136,39.2,88405,16621,34.92,50924,10667,43549,19139,31881.85714,7546,39203,61591,62688,39427.85714
1/25/2023,5,Agency_5,Wednesday,21247,13185,Sports Event,1,136,34.43,88405,16621,35.98,32643,6560,19831,11891,32084.14286,7730.857143,34432,39203,31722,39815
1/26/2023,5,Agency_5,Thursday,20354,11571,Sports Event,1,136,31.93,88405,16621,37.56,21247,13185,36990,7694,29707.57143,8284.714286,31925,34432,44684,37992.28571
1/27/2023,5,Agency_5,Friday,19737,15255,Sports Event,0,136,34.99,88405,16621,35.29,20354,11571,33381,3901,27758.42857,9906.714286,34992,31925,37282,37665.14286
1/28/2023,5,Agency_5,Saturday,44200,11516,Sports Event,0,136,55.72,88405,16621,25.68,19737,15255,28578,8358,29990.14286,10357.85714,55716,34992,36936,40348
1/29/2023,5,Agency_5,Sunday,61584,10231,Concert,1,136,71.82,88405,16621,17.88,44200,11516,20826,3751,35812.71429,11283.57143,71815,55716,24577,47096.28571
1/30/2023,5,Agency_5,Monday,22717,5399,None,0,136,28.12,88405,16621,40.7,61584,10231,50924,10667,31783.14286,10531,28116,71815,61591,42314.14286
1/31/2023,5,Agency_5,Tuesday,31980,12824,Festival,0,136,44.8,88405,16621,30.87,22717,5399,32643,6560,31688.42857,11425.85714,44804,28116,39203,43114.28571
2/1/2023,5,Agency_5,Wednesday,46140,13273,Festival,1,136,59.41,88405,16621,23.48,31980,12824,21247,13185,35244.57143,11438.42857,59413,44804,34432,46683
2/2/2023,5,Agency_5,Thursday,11725,3079,None,0,136,14.8,88405,16621,47.82,46140,13273,20354,11571,34011.85714,10225.28571,14804,59413,31925,44237.14286
2/3/2023,5,Agency_5,Friday,29079,8816,Festival,0,136,37.9,88405,16621,35.13,11725,3079,19737,15255,35346.42857,9305.428571,37895,14804,34992,44651.85714
2/4/2023,5,Agency_5,Saturday,25826,21708,Sports Event,0,136,47.54,88405,16621,27.73,29079,8816,44200,11516,32721.57143,10761.42857,47534,37895,55716,43483
2/5/2023,5,Agency_5,Sunday,33097,8065,None,0,136,41.16,88405,16621,33.64,25826,21708,61584,10231,28652,10452,41162,47534,71815,39104
2/6/2023,5,Agency_5,Monday,39702,10888,Festival,1,136,50.59,88405,16621,28.36,33097,8065,22717,5399,31078.42857,11236.14286,50590,41162,28116,42314.57143
2/7/2023,5,Agency_5,Tuesday,19812,7215,None,1,136,27.03,88405,16621,40.88,39702,10888,31980,12824,29340.14286,10434.85714,27027,50590,44804,39775
2/8/2023,5,Agency_5,Wednesday,41511,5988,Concert,1,136,47.5,88405,16621,30.89,19812,7215,46140,13273,28678.85714,9394.142857,47499,27027,59413,38073
2/9/2023,5,Agency_5,Thursday,32505,7971,Concert,0,136,40.48,88405,16621,34,41511,5988,11725,3079,31647.42857,10093,40476,47499,14804,41740.42857
2/10/2023,5,Agency_5,Friday,13598,4590,None,1,136,18.19,88405,16621,45.82,32505,7971,29079,8816,29435.85714,9489.285714,18188,40476,37895,38925.14286
2/11/2023,5,Agency_5,Saturday,32275,19392,Concert,0,136,51.67,88405,16621,26.12,13598,4590,25826,21708,30357.14286,9158.428571,51667,18188,47534,39515.57143
2/12/2023,5,Agency_5,Sunday,53309,7205,Sports Event,1,136,60.52,88405,16621,24.14,32275,19392,33097,8065,33244.57143,9035.571429,60514,51667,41162,42280.14286
2/13/2023,5,Agency_5,Monday,43738,4533,Festival,1,136,48.27,88405,16621,30.79,53309,7205,39702,10888,33821.14286,8127.714286,48271,60514,50590,41948.85714
2/14/2023,5,Agency_5,Tuesday,38119,6896,Concert,0,136,45.02,88405,16621,31.95,43738,4533,19812,7215,36436.42857,8082.142857,45015,48271,27027,44518.57143
2/15/2023,5,Agency_5,Wednesday,25390,10711,None,1,136,36.1,88405,16621,35.64,38119,6896,41511,5988,34133.42857,8756.857143,36101,45015,47499,42890.28571
2/16/2023,5,Agency_5,Thursday,20346,3748,Sports Event,0,136,24.09,88405,16621,43.04,25390,10711,32505,7971,32396.42857,8153.571429,24094,36101,40476,40550
2/17/2023,5,Agency_5,Friday,22206,9906,None,1,136,32.11,88405,16621,37.8,20346,3748,13598,4590,33626.14286,8913,32112,24094,18188,42539.14286
2/18/2023,5,Agency_5,Saturday,19348,0,None,1,136,19.35,88405,16621,46.16,22206,9906,32275,19392,31779.42857,6142.714286,19348,32112,51667,37922.14286
2/19/2023,5,Agency_5,Sunday,27680,11107,None,1,136,38.79,88405,16621,34.22,19348,0,53309,7205,28118.14286,6700.142857,38787,19348,60514,34818.28571
2/20/2023,5,Agency_5,Monday,39001,6924,Sports Event,0,136,45.93,88405,16621,31.49,27680,11107,43738,4533,27441.42857,7041.714286,45925,38787,48271,34483.14286
2/21/2023,5,Agency_5,Tuesday,17942,7307,None,0,136,25.25,88405,16621,41.75,39001,6924,38119,6896,24559,7100.428571,25249,45925,45015,31659.42857
2/22/2023,5,Agency_5,Wednesday,15976,7177,Concert,0,136,23.15,88405,16621,42.82,17942,7307,25390,10711,23214.14286,6595.571429,23153,25249,36101,29809.71429
2/23/2023,5,Agency_5,Thursday,31428,10026,Festival,0,136,41.45,88405,16621,33.1,15976,7177,20346,3748,24797.28571,7492.428571,41454,23153,24094,32289.71429
2/24/2023,5,Agency_5,Friday,26175,8615,Sports Event,0,136,34.79,88405,16621,36.72,31428,10026,22206,9906,25364.28571,7308,34790,41454,32112,32672.28571
2/25/2023,5,Agency_5,Saturday,17685,11395,Festival,1,136,29.08,88405,16621,39.02,26175,8615,19348,0,25126.71429,8935.857143,29080,34790,19348,34062.57143
2/26/2023,5,Agency_5,Sunday,52104,9390,Sports Event,1,136,61.5,88405,16621,23.21,17685,11395,27680,11107,28615.85714,8690.571429,61494,29080,38787,37306.42857
2/27/2023,5,Agency_5,Monday,30441,10018,Festival,0,136,40.46,88405,16621,33.6,52104,9390,39001,6924,27393,9132.571429,40459,61494,45925,36525.57143
2/28/2023,5,Agency_5,Tuesday,27430,9078,Sports Event,0,136,36.51,88405,16621,35.77,30441,10018,17942,7307,28748.42857,9385.571429,36508,40459,25249,38134
3/1/2023,5,Agency_5,Wednesday,29612,10914,Festival,1,136,40.53,88405,16621,33.39,27430,9078,15976,7177,30696.42857,9919.428571,40526,36508,23153,40615.85714
3/2/2023,5,Agency_5,Thursday,34576,9032,Festival,0,136,43.61,88405,16621,32.23,29612,10914,31428,10026,31146.14286,9777.428571,43608,40526,41454,40923.57143
3/3/2023,5,Agency_5,Friday,25600,9261,Sports Event,0,136,34.86,88405,16621,36.55,34576,9032,26175,8615,31064,9869.714286,34861,43608,34790,40933.71429
3/4/2023,5,Agency_5,Saturday,55160,2784,Festival,1,136,57.95,88405,16621,26.31,25600,9261,17685,11395,36417.57143,8639.571429,57944,34861,29080,45057.14286
3/5/2023,5,Agency_5,Sunday,60360,13387,Sports Event,1,136,73.75,88405,16621,16.29,55160,2784,52104,9390,37597,9210.571429,73747,57944,61494,46807.57143
3/6/2023,5,Agency_5,Monday,43147,17597,Concert,1,136,60.75,88405,16621,21.94,60360,13387,30441,10018,39412.14286,10293.28571,60744,73747,40459,49705.42857
3/7/2023,5,Agency_5,Tuesday,13141,3581,None,0,136,16.72,88405,16621,46.76,43147,17597,27430,9078,37370.85714,9508,16722,60744,36508,46878.85714
3/8/2023,5,Agency_5,Wednesday,18557,3432,None,0,136,21.99,88405,16621,44.16,13141,3581,29612,10914,35791.57143,8439.142857,21989,16722,40526,44230.71429
3/9/2023,5,Agency_5,Thursday,55914,7820,Festival,1,136,63.73,88405,16621,22.41,18557,3432,34576,9032,38839.85714,8266,63734,21989,43608,47105.85714
3/10/2023,5,Agency_5,Friday,25833,9193,Concert,0,136,35.03,88405,16621,36.49,55914,7820,25600,9261,38873.14286,8256.285714,35026,63734,34861,47129.42857
3/11/2023,5,Agency_5,Saturday,32734,13019,Sports Event,1,136,45.75,88405,16621,30.36,25833,9193,55160,2784,35669.42857,9718.428571,45753,35026,57944,45387.85714
3/12/2023,5,Agency_5,Sunday,38856,9578,Sports Event,0,136,48.43,88405,16621,29.7,32734,13019,60360,13387,32597.42857,9174.285714,48434,45753,73747,41771.71429
3/13/2023,5,Agency_5,Monday,38089,9379,Sports Event,1,136,47.47,88405,16621,30.23,38856,9578,43147,17597,31874.85714,8000.285714,47468,48434,60744,39875.14286
3/14/2023,5,Agency_5,Tuesday,16155,7900,None,1,136,24.06,88405,16621,42.23,38089,9379,13141,3581,32305.42857,8617.285714,24055,47468,16722,40922.71429
3/15/2023,5,Agency_5,Wednesday,28774,5036,None,0,136,33.81,88405,16621,37.92,16155,7900,18557,3432,33765,8846.428571,33810,24055,21989,42611.42857
3/16/2023,5,Agency_5,Thursday,27463,8939,None,1,136,36.4,88405,16621,35.85,28774,5036,55914,7820,29700.57143,9006.285714,36402,33810,63734,38706.85714
3/17/2023,5,Agency_5,Friday,20479,14288,Concert,0,136,34.77,88405,16621,35.6,27463,8939,25833,9193,28935.71429,9734.142857,34767,36402,35026,38669.85714
3/18/2023,5,Agency_5,Saturday,37819,18261,Concert,0,136,56.08,88405,16621,24.14,20479,14288,32734,13019,29662.14286,10483,56080,34767,45753,40145.14286
3/19/2023,5,Agency_5,Sunday,29401,19085,Concert,0,136,48.49,88405,16621,27.78,37819,18261,38856,9578,28311.42857,11841.14286,48486,56080,48434,40152.57143
3/20/2023,5,Agency_5,Monday,35812,10380,Sports Event,0,136,46.19,88405,16621,30.66,29401,19085,38089,9379,27986.14286,11984.14286,46192,48486,47468,39970.28571
3/21/2023,5,Agency_5,Tuesday,31755,7653,Sports Event,0,136,39.41,88405,16621,34.6,35812,10380,16155,7900,30214.71429,11948.85714,39408,46192,24055,42163.57143
3/22/2023,5,Agency_5,Wednesday,50703,12566,Concert,1,136,63.27,88405,16621,21.69,31755,7653,28774,5036,33347.42857,13024.57143,63269,39408,33810,46372
3/23/2023,5,Agency_5,Thursday,15246,4700,Festival,0,136,19.95,88405,16621,44.92,50703,12566,27463,8939,31602.14286,12419,19946,63269,36402,44021.14286
3/24/2023,5,Agency_5,Friday,24791,7866,None,1,136,32.66,88405,16621,37.94,15246,4700,20479,14288,32218.14286,11501.57143,32657,19946,34767,43719.71429
3/25/2023,5,Agency_5,Saturday,46137,23010,Sports Event,1,136,69.15,88405,16621,16.66,24791,7866,37819,18261,33406.42857,12180,69147,32657,56080,45586.42857
3/26/2023,5,Agency_5,Sunday,23970,16357,Festival,1,136,40.33,88405,16621,32.4,46137,23010,29401,19085,32630.57143,11790.28571,40327,69147,48486,44420.85714
3/27/2023,5,Agency_5,Monday,14183,9126,None,1,136,23.31,88405,16621,42.36,23970,16357,35812,10380,29540.71429,11611.14286,23309,40327,46192,41151.85714
3/28/2023,5,Agency_5,Tuesday,25385,8174,None,1,136,33.56,88405,16621,37.42,14183,9126,31755,7653,28630.71429,11685.57143,33559,23309,39408,40316.28571
3/29/2023,5,Agency_5,Wednesday,23520,12848,Concert,0,136,36.37,88405,16621,35.08,25385,8174,50703,12566,24747.42857,11725.85714,36368,33559,63269,36473.28571
3/30/2023,5,Agency_5,Thursday,25208,6167,None,0,136,31.38,88405,16621,38.92,23520,12848,15246,4700,26170.57143,11935.42857,31375,36368,19946,38106
3/31/2023,5,Agency_5,Friday,25157,8622,None,1,136,33.78,88405,16621,37.22,25208,6167,24791,7866,26222.85714,12043.42857,33779,31375,32657,38266.28571
4/1/2023,5,Agency_5,Saturday,38528,20763,Festival,1,136,59.29,88405,16621,22.04,25157,8622,46137,23010,25135.85714,11722.42857,59291,33779,69147,36858.28571
4/2/2023,5,Agency_5,Sunday,66097,22094,Festival,1,136,88.19,88405,16621,7.32,38528,20763,23970,16357,31154,12542,88191,59291,40327,43696
4/3/2023,5,Agency_5,Monday,31884,13618,Sports Event,1,136,45.5,88405,16621,30.36,66097,22094,14183,9126,33682.71429,13183.71429,45502,88191,23309,46866.42857
4/4/2023,5,Agency_5,Tuesday,13534,6144,None,0,136,19.68,88405,16621,44.77,31884,13618,25385,8174,31989.71429,12893.71429,19678,45502,33559,44883.42857
4/5/2023,5,Agency_5,Wednesday,43393,2998,Festival,1,136,46.39,88405,16621,32.04,13534,6144,23520,12848,34828.71429,11486.57143,46391,19678,36368,46315.28571
4/6/2023,5,Agency_5,Thursday,27672,10550,Concert,1,136,38.22,88405,16621,34.62,43393,2998,25208,6167,35180.71429,12112.71429,38222,46391,31375,47293.42857
4/7/2023,5,Agency_5,Friday,24043,3613,None,1,136,27.66,88405,16621,41.29,27672,10550,25157,8622,35021.57143,11397.14286,27656,38222,33779,46418.71429
4/8/2023,5,Agency_5,Saturday,39499,12159,Festival,0,136,51.66,88405,16621,27.58,24043,3613,38528,20763,35160.28571,10168,51658,27656,59291,45328.28571
4/9/2023,5,Agency_5,Sunday,29683,6348,None,1,136,36.03,88405,16621,36.55,39499,12159,66097,22094,29958.28571,7918.571429,36031,51658,88191,37876.85714
4/10/2023,5,Agency_5,Monday,49223,19777,Festival,1,136,69,88405,16621,17.38,29683,6348,31884,13618,32435.28571,8798.428571,69000,36031,45502,41233.71429
4/11/2023,5,Agency_5,Tuesday,22856,5285,None,1,136,28.14,88405,16621,40.71,49223,19777,13534,6144,33767,8675.714286,28141,69000,19678,42442.71429
4/12/2023,5,Agency_5,Wednesday,43789,10193,Festival,1,136,53.98,88405,16621,26.81,22856,5285,43393,2998,33823.57143,9703.571429,53982,28141,46391,43527.14286
4/13/2023,5,Agency_5,Thursday,37640,15420,Festival,1,136,53.06,88405,16621,26.22,43789,10193,27672,10550,35247.57143,10399.28571,53060,53982,38222,45646.85714
4/14/2023,5,Agency_5,Friday,10453,7636,None,0,136,18.09,88405,16621,45.27,37640,15420,24043,3613,33306.14286,10974,18089,53060,27656,44280.14286
4/15/2023,5,Agency_5,Saturday,47649,12923,Concert,1,136,60.57,88405,16621,22.97,10453,7636,39499,12159,34470.42857,11083.14286,60572,18089,51658,45553.57143
4/16/2023,5,Agency_5,Sunday,45754,15234,Sports Event,1,136,60.99,88405,16621,22.3,47649,12923,29683,6348,36766.28571,12352.57143,60988,60572,36031,49118.85714
4/17/2023,5,Agency_5,Monday,22118,19013,Festival,1,136,41.13,88405,16621,31.47,45754,15234,49223,19777,32894.14286,12243.42857,41131,60988,69000,45137.57143
4/18/2023,5,Agency_5,Tuesday,20206,5886,None,0,136,26.09,88405,16621,41.61,22118,19013,22856,5285,32515.57143,12329.28571,26092,41131,28141,44844.85714
4/19/2023,5,Agency_5,Wednesday,37135,5026,Sports Event,0,136,42.16,88405,16621,33.75,20206,5886,43789,10193,31565,11591.14286,42161,26092,53982,43156.14286
4/20/2023,5,Agency_5,Thursday,43615,10624,Sports Event,1,136,54.24,88405,16621,26.59,37135,5026,37640,15420,32418.57143,10906,54239,42161,53060,43324.57143
4/21/2023,5,Agency_5,Friday,36349,1266,Festival,0,136,37.62,88405,16621,36.78,43615,10624,10453,7636,36118,9996,37615,54239,18089,46114
4/22/2023,5,Agency_5,Saturday,35107,8384,Concert,0,136,43.49,88405,16621,32.41,36349,1266,47649,12923,34326.28571,9347.571429,43491,37615,60572,43673.85714
4/23/2023,5,Agency_5,Sunday,51856,18378,Festival,1,136,70.24,88405,16621,17.04,35107,8384,45754,15234,35198,9796.714286,70234,43491,60988,44994.71429
4/24/2023,5,Agency_5,Monday,24691,6077,Concert,0,136,30.77,88405,16621,39.24,51856,18378,22118,19013,35565.57143,7948.714286,30768,70234,41131,43514.28571
4/25/2023,5,Agency_5,Tuesday,29169,5450,Concert,0,136,34.62,88405,16621,37.44,24691,6077,20206,5886,36846,7886.428571,34619,30768,26092,44732.42857
4/26/2023,5,Agency_5,Wednesday,36313,7243,Concert,0,136,43.56,88405,16621,32.61,29169,5450,37135,5026,36728.57143,8203.142857,43556,34619,42161,44931.71429
4/27/2023,5,Agency_5,Thursday,8197,7225,Concert,0,136,15.42,88405,16621,46.68,36313,7243,43615,10624,31668.85714,7717.571429,15422,43556,54239,39386.42857
4/28/2023,5,Agency_5,Friday,22210,2952,Sports Event,0,136,25.16,88405,16621,42.66,8197,7225,36349,1266,29649,7958.428571,25162,15422,37615,37607.42857
4/29/2023,5,Agency_5,Saturday,24861,11531,Festival,0,136,36.39,88405,16621,35.33,22210,2952,35107,8384,28185.28571,8408,36392,25162,43491,36593.28571
4/30/2023,5,Agency_5,Sunday,62344,17406,Festival,1,136,79.75,88405,16621,12.48,24861,11531,51856,18378,29683.57143,8269.142857,79750,36392,70234,37952.71429
5/1/2023,5,Agency_5,Monday,33085,14068,Sports Event,1,136,47.15,88405,16621,29.45,62344,17406,24691,6077,30882.71429,9410.714286,47153,79750,30768,40293.42857
5/2/2023,5,Agency_5,Tuesday,17704,3610,None,0,136,21.31,88405,16621,44.46,33085,14068,29169,5450,29244.85714,9147.857143,21314,47153,34619,38392.71429
5/3/2023,5,Agency_5,Wednesday,27744,3560,Concert,1,136,31.31,88405,16621,39.47,17704,3610,36313,7243,28020.71429,8621.714286,31304,21314,43556,36642.42857
5/4/2023,5,Agency_5,Thursday,35197,12652,Sports Event,1,136,47.85,88405,16621,29.38,27744,3560,8197,7225,31877.85714,9397,47849,31304,15422,41274.85714
5/5/2023,5,Agency_5,Friday,38056,9919,Concert,1,136,47.98,88405,16621,29.87,35197,12652,22210,2952,34141.57143,10392.28571,47975,47849,25162,44533.85714
5/6/2023,5,Agency_5,Saturday,35734,19232,Festival,1,136,54.97,88405,16621,24.51,38056,9919,24861,11531,35694.85714,11492.42857,54966,47975,36392,47187.28571
5/7/2023,5,Agency_5,Sunday,31388,20271,Concert,1,136,51.66,88405,16621,25.95,35734,19232,62344,17406,31272.57143,11901.71429,51659,54966,79750,43174.28571
5/8/2023,5,Agency_5,Monday,19484,4893,None,1,136,24.38,88405,16621,42.67,31388,20271,33085,14068,29329.57143,10591,24377,51659,47153,39920.57143
5/9/2023,5,Agency_5,Tuesday,16465,5595,None,1,136,22.06,88405,16621,43.69,19484,4893,17704,3610,29152.57143,10874.57143,22060,24377,21314,40027.14286
5/10/2023,5,Agency_5,Wednesday,24876,6031,None,0,136,30.91,88405,16621,39.18,16465,5595,27744,3560,28742.85714,11227.57143,30907,22060,31304,39970.42857
5/11/2023,5,Agency_5,Thursday,37338,10274,Concert,0,136,47.61,88405,16621,29.98,24876,6031,35197,12652,29048.71429,10887.85714,47612,30907,47849,39936.57143
5/12/2023,5,Agency_5,Friday,21721,7374,Concert,0,136,29.1,88405,16621,39.81,37338,10274,38056,9919,26715.14286,10524.28571,29095,47612,47975,37239.42857
5/13/2023,5,Agency_5,Saturday,37671,23703,Festival,1,136,61.37,88405,16621,20.41,21721,7374,35734,19232,26991.85714,11163,61374,29095,54966,38154.85714
5/14/2023,5,Agency_5,Sunday,16819,8823,None,0,136,25.64,88405,16621,41.25,37671,23703,31388,20271,24910.57143,9527.571429,25642,61374,51659,34438.14286
5/15/2023,5,Agency_5,Monday,36696,14720,Sports Event,0,136,51.42,88405,16621,27.18,16819,8823,19484,4893,27369.42857,10931.42857,51416,25642,24377,38300.85714
5/16/2023,5,Agency_5,Tuesday,26926,10920,Concert,0,136,37.85,88405,16621,34.73,36696,14720,16465,5595,28863.85714,11692.14286,37846,51416,22060,40556
5/17/2023,5,Agency_5,Wednesday,61245,8958,Concert,1,136,70.2,88405,16621,18.94,26926,10920,24876,6031,34059.42857,12110.28571,70203,37846,30907,46169.71429
5/18/2023,5,Agency_5,Thursday,24031,2948,Festival,1,136,26.98,88405,16621,41.76,61245,8958,37338,10274,32158.42857,11063.71429,26979,70203,47612,43222.14286
5/19/2023,5,Agency_5,Friday,45947,2934,Sports Event,1,136,48.88,88405,16621,30.81,24031,2948,21721,7374,35619.28571,10429.42857,48881,26979,29095,46048.71429
5/20/2023,5,Agency_5,Saturday,42442,18174,Festival,1,136,60.62,88405,16621,21.89,45947,2934,37671,23703,36300.85714,9639.571429,60616,48881,61374,45940.42857
5/21/2023,5,Agency_5,Sunday,37665,12928,Festival,0,136,50.59,88405,16621,27.95,42442,18174,16819,8823,39278.85714,10226,50593,60616,25642,49504.85714
5/22/2023,5,Agency_5,Monday,41166,17985,Sports Event,1,136,59.15,88405,16621,22.66,37665,12928,36696,14720,39917.42857,10692.42857,59151,50593,51416,50609.85714
5/23/2023,5,Agency_5,Tuesday,22857,6198,Sports Event,0,136,29.06,88405,16621,40.07,41166,17985,26926,10920,39336.14286,10017.85714,29055,59151,37846,49354
5/24/2023,5,Agency_5,Wednesday,20976,9324,None,1,136,30.3,88405,16621,38.82,22857,6198,61245,8958,33583.42857,10070.14286,30300,29055,70203,43653.57143
5/25/2023,5,Agency_5,Thursday,47776,14046,Festival,1,136,61.82,88405,16621,22.12,20976,9324,24031,2948,36975.57143,11655.57143,61822,30300,26979,48631.14286
5/26/2023,5,Agency_5,Friday,33692,3700,None,1,136,37.39,88405,16621,36.4,47776,14046,45947,2934,35224.85714,11765,37392,61822,48881,46989.85714
5/27/2023,5,Agency_5,Saturday,44204,14643,None,1,136,58.85,88405,16621,23.48,33692,3700,42442,18174,35476.57143,11260.57143,58847,37392,60616,46737.14286
5/28/2023,5,Agency_5,Sunday,55406,26493,Festival,1,136,81.9,88405,16621,9.59,44204,14643,37665,12928,38011,13198.42857,81899,58847,50593,51209.42857
5/29/2023,5,Agency_5,Monday,22846,9403,Festival,1,136,32.25,88405,16621,37.83,55406,26493,41166,17985,35393.85714,11972.42857,32249,81899,59151,47366.28571
5/30/2023,5,Agency_5,Tuesday,24484,10951,Festival,0,136,35.44,88405,16621,35.93,22846,9403,22857,6198,35626.28571,12651.42857,35435,32249,29055,48277.71429
5/31/2023,5,Agency_5,Wednesday,22123,11073,Concert,0,136,33.2,88405,16621,37.02,24484,10951,20976,9324,35790.14286,12901.28571,33196,35435,30300,48691.42857
6/1/2023,5,Agency_5,Thursday,34907,8946,None,1,136,43.85,88405,16621,32.12,22123,11073,47776,14046,33951.71429,12172.71429,43853,33196,61822,46124.42857
6/2/2023,5,Agency_5,Friday,32127,5140,Festival,0,136,37.27,88405,16621,36.18,34907,8946,33692,3700,33728.14286,12378.42857,37267,43853,37392,46106.57143
6/3/2023,5,Agency_5,Saturday,24593,13648,None,1,136,38.24,88405,16621,33.99,32127,5140,44204,14643,30926.57143,12236.28571,38241,37267,58847,43162.85714
6/4/2023,5,Agency_5,Sunday,55916,15225,Festival,1,136,71.14,88405,16621,17.22,24593,13648,55406,26493,30999.42857,10626.57143,71141,38241,81899,41626
6/5/2023,5,Agency_5,Monday,34924,2256,Sports Event,1,136,37.18,88405,16621,36.8,55916,15225,22846,9403,32724.85714,9605.571429,37180,71141,32249,42330.42857
6/6/2023,5,Agency_5,Tuesday,21967,14997,Sports Event,0,136,36.96,88405,16621,34.36,34924,2256,24484,10951,32365.28571,10183.57143,36964,37180,35435,42548.85714
6/7/2023,5,Agency_5,Wednesday,26514,12799,Concert,1,136,39.31,88405,16621,33.62,21967,14997,22123,11073,32992.57143,10430.14286,39313,36964,33196,43422.71429
6/8/2023,5,Agency_5,Thursday,48822,5926,Concert,1,136,54.75,88405,16621,27.28,26514,12799,34907,8946,34980.42857,9998.714286,54748,39313,43853,44979.14286
6/9/2023,5,Agency_5,Friday,40799,16362,Festival,1,136,57.16,88405,16621,23.98,48822,5926,32127,5140,36219.28571,11601.85714,57161,54748,37267,47821.14286
6/10/2023,5,Agency_5,Saturday,36111,23726,Concert,0,136,59.84,88405,16621,21.17,40799,16362,24593,13648,37864.71429,13041.57143,59837,57161,38241,50906.28571
6/11/2023,5,Agency_5,Sunday,20982,15728,Festival,0,136,36.71,88405,16621,34.34,36111,23726,55916,15225,32874.14286,13113.42857,36710,59837,71141,45987.57143
6/12/2023,5,Agency_5,Monday,28702,11123,Sports Event,0,136,39.83,88405,16621,33.7,20982,15728,34924,2256,31985.28571,14380.14286,39825,36710,37180,46365.42857
6/13/2023,5,Agency_5,Tuesday,33309,6006,Festival,0,136,39.32,88405,16621,34.98,28702,11123,21967,14997,33605.57143,13095.71429,39315,39825,36964,46701.28571
6/14/2023,5,Agency_5,Wednesday,31716,2182,Festival,0,136,33.9,88405,16621,38.45,33309,6006,26514,12799,34348.71429,11579,33898,39315,39313,45927.71429
6/15/2023,5,Agency_5,Thursday,44881,13318,Concert,1,136,58.2,88405,16621,24.07,31716,2182,48822,5926,33785.71429,12635,58199,33898,54748,46420.71429
6/16/2023,5,Agency_5,Friday,45226,16936,Concert,1,136,62.16,88405,16621,21.37,44881,13318,40799,16362,34418.14286,12717,62162,58199,57161,47135.14286
6/17/2023,5,Agency_5,Saturday,51100,16385,Sports Event,1,136,67.49,88405,16621,18.82,45226,16936,36111,23726,36559.42857,11668.28571,67485,62162,59837,48227.71429
6/18/2023,5,Agency_5,Sunday,36489,11061,Festival,1,136,47.55,88405,16621,29.85,51100,16385,20982,15728,38774.71429,11001.57143,47550,67485,36710,49776.28571
6/19/2023,5,Agency_5,Monday,50569,18735,Festival,1,136,69.3,88405,16621,17.44,36489,11061,28702,11123,41898.57143,12089,69304,47550,39825,53987.57143
6/20/2023,5,Agency_5,Tuesday,24451,7128,None,1,136,31.58,88405,16621,38.62,50569,18735,33309,6006,40633.14286,12249.28571,31579,69304,39315,52882.42857
6/21/2023,5,Agency_5,Wednesday,15476,7345,None,0,136,22.82,88405,16621,42.96,24451,7128,31716,2182,38313.14286,12986.85714,22821,31579,33898,51300
6/22/2023,5,Agency_5,Thursday,34990,15099,Sports Event,0,136,50.09,88405,16621,27.77,15476,7345,44881,13318,36900.14286,13241.28571,50089,22821,58199,50141.42857
6/23/2023,5,Agency_5,Friday,20290,5940,None,1,136,26.23,88405,16621,41.53,34990,15099,45226,16936,33337.85714,11670.42857,26230,50089,62162,45008.28571
6/24/2023,5,Agency_5,Saturday,49507,19467,Festival,1,136,68.97,88405,16621,17.46,20290,5940,51100,16385,33110.28571,12110.71429,68974,26230,67485,45221
6/25/2023,5,Agency_5,Sunday,22705,4230,None,0,136,26.94,88405,16621,41.52,49507,19467,36489,11061,31141.14286,11134.85714,26935,68974,47550,42276
6/26/2023,5,Agency_5,Monday,36610,10951,Concert,0,136,47.56,88405,16621,29.87,22705,4230,50569,18735,29147,10022.85714,47561,26935,69304,39169.85714
6/27/2023,5,Agency_5,Tuesday,30065,18349,Festival,1,136,48.41,88405,16621,27.96,36610,10951,24451,7128,29949,11625.85714,48414,47561,31579,41574.85714
6/28/2023,5,Agency_5,Wednesday,38775,8955,Sports Event,0,136,47.73,88405,16621,30.18,30065,18349,15476,7345,33277.42857,11855.85714,47730,48414,22821,45133.28571
6/29/2023,5,Agency_5,Thursday,30595,10383,Festival,0,136,40.98,88405,16621,33.27,38775,8955,34990,15099,32649.57143,11182.14286,40978,47730,50089,43831.71429
6/30/2023,5,Agency_5,Friday,20398,7084,None,1,136,27.48,88405,16621,40.68,30595,10383,20290,5940,32665,11345.57143,27482,40978,26230,44010.57143
7/1/2023,5,Agency_5,Saturday,16628,14921,Festival,0,136,31.55,88405,16621,37.08,20398,7084,49507,19467,27968,10696.14286,31549,27482,68974,38664.14286
7/2/2023,5,Agency_5,Sunday,21945,17693,Festival,0,136,39.64,88405,16621,32.48,16628,14921,22705,4230,27859.42857,12619.42857,39638,31549,26935,40478.85714
7/3/2023,5,Agency_5,Monday,23853,6406,None,1,136,30.26,88405,16621,39.43,21945,17693,36610,10951,26037,11970.14286,30259,39638,47561,38007.14286
7/4/2023,5,Agency_5,Tuesday,25291,7519,Festival,0,136,32.81,88405,16621,37.93,23853,6406,30065,18349,25355,10423,32810,30259,48414,35778
7/5/2023,5,Agency_5,Wednesday,40638,40,Concert,0,136,40.68,88405,16621,35.49,25291,7519,38775,8955,25621.14286,9149.428571,40678,32810,47730,34770.57143
7/6/2023,5,Agency_5,Thursday,39576,9649,Sports Event,0,136,49.23,88405,16621,29.29,40638,40,30595,10383,26904.14286,9044.571429,49225,40678,40978,35948.71429
7/7/2023,5,Agency_5,Friday,27229,6780,Concert,1,136,34.01,88405,16621,37.48,39576,9649,20398,7084,27880,9001.142857,34009,49225,27482,36881.14286
7/8/2023,5,Agency_5,Saturday,66411,9616,Sports Event,1,136,76.03,88405,16621,15.9,27229,6780,16628,14921,34991.85714,8243.285714,76027,34009,31549,43235.14286
7/9/2023,5,Agency_5,Sunday,33305,22505,Sports Event,1,136,55.81,88405,16621,23.43,66411,9616,21945,17693,36614.71429,8930.714286,55810,76027,39638,45545.42857
7/10/2023,5,Agency_5,Monday,32538,5310,Sports Event,0,136,37.85,88405,16621,35.85,33305,22505,23853,6406,37855.42857,8774.142857,37848,55810,30259,46629.57143
7/11/2023,5,Agency_5,Tuesday,21083,2948,None,0,136,24.03,88405,16621,43.23,32538,5310,25291,7519,37254.28571,8121.142857,24031,37848,32810,45375.42857
7/12/2023,5,Agency_5,Wednesday,38256,12107,Festival,0,136,50.36,88405,16621,28.23,21083,2948,40638,40,36914,9845,50363,24031,40678,46759
7/13/2023,5,Agency_5,Thursday,33990,9729,Festival,0,136,43.72,88405,16621,32.03,38256,12107,39576,9649,36116,9856.428571,43719,50363,49225,45972.42857
7/14/2023,5,Agency_5,Friday,28805,4999,None,0,136,33.8,88405,16621,37.94,33990,9729,27229,6780,36341.14286,9602,33804,43719,34009,45943.14286
7/15/2023,5,Agency_5,Saturday,25362,13034,Concert,0,136,38.4,88405,16621,34.03,28805,4999,66411,9616,30477,10090.28571,38396,33804,76027,40567.28571
7/16/2023,5,Agency_5,Sunday,71206,9189,Festival,1,136,80.4,88405,16621,13.8,25362,13034,33305,22505,35891.42857,8188,80395,38396,55810,44079.42857
7/17/2023,5,Agency_5,Monday,27288,9914,Concert,0,136,37.2,88405,16621,35.25,71206,9189,32538,5310,35141.42857,8845.714286,37202,80395,37848,43987.14286
7/18/2023,5,Agency_5,Tuesday,38473,7223,Sports Event,1,136,45.7,88405,16621,31.54,27288,9914,21083,2948,37625.71429,9456.428571,45696,37202,24031,47082.14286
7/19/2023,5,Agency_5,Wednesday,38413,16388,Concert,0,136,54.8,88405,16621,25.16,38473,7223,38256,12107,37648.14286,10068,54801,45696,50363,47716.14286
7/20/2023,5,Agency_5,Thursday,27274,4467,None,1,136,31.74,88405,16621,39.07,38413,16388,33990,9729,36688.71429,9316.285714,31741,54801,43719,46005
7/21/2023,5,Agency_5,Friday,23897,13125,Festival,1,136,37.02,88405,16621,34.7,27274,4467,28805,4999,35987.57143,10477.14286,37022,31741,33804,46464.71429
7/22/2023,5,Agency_5,Saturday,59714,18409,Festival,1,136,78.12,88405,16621,13.09,23897,13125,25362,13034,40895,11245,78123,37022,38396,52140
7/23/2023,5,Agency_5,Sunday,46769,11822,Concert,1,136,58.59,88405,16621,24.18,59714,18409,71206,9189,37404,11621.14286,58591,78123,80395,49025.14286
7/24/2023,5,Agency_5,Monday,28351,15872,Sports Event,1,136,44.22,88405,16621,30.55,46769,11822,27288,9914,37555.85714,12472.28571,44223,58591,37202,50028.14286
7/25/2023,5,Agency_5,Tuesday,36852,3243,Concert,0,136,40.1,88405,16621,35.14,28351,15872,38473,7223,37324.28571,11903.71429,40095,44223,45696,49228
7/26/2023,5,Agency_5,Wednesday,41923,10451,Sports Event,0,136,52.38,88405,16621,27.56,36852,3243,38413,16388,37825.71429,11055.57143,52374,40095,54801,48881.28571
7/27/2023,5,Agency_5,Thursday,40495,3935,Concert,0,136,44.43,88405,16621,32.83,41923,10451,27274,4467,39714.42857,10979.57143,44430,52374,31741,50694
7/28/2023,5,Agency_5,Friday,19755,7993,Concert,0,136,27.75,88405,16621,40.36,40495,3935,23897,13125,39122.71429,10246.42857,27748,44430,37022,49369.14286
7/29/2023,5,Agency_5,Saturday,27015,11169,None,0,136,38.19,88405,16621,34.51,19755,7993,59714,18409,34451.42857,9212.142857,38184,27748,78123,43663.57143
7/30/2023,5,Agency_5,Sunday,36706,8215,None,1,136,44.92,88405,16621,31.73,27015,11169,46769,11822,33013.85714,8696.857143,44921,38184,58591,41710.71429
7/31/2023,5,Agency_5,Monday,19328,10444,None,1,136,29.77,88405,16621,38.86,36706,8215,28351,15872,31724.85714,7921.428571,29772,44921,44223,39646.28571
8/1/2023,5,Agency_5,Tuesday,22764,14035,Festival,0,136,36.8,88405,16621,34.63,19328,10444,36852,3243,29712.28571,9463.142857,36799,29772,40095,39175.42857
8/2/2023,5,Agency_5,Wednesday,18578,8181,None,0,136,26.76,88405,16621,40.82,22764,14035,41923,10451,26377.28571,9138.857143,26759,36799,52374,35516.14286
8/3/2023,5,Agency_5,Thursday,23394,4726,None,0,136,28.12,88405,16621,40.83,18578,8181,40495,3935,23934.28571,9251.857143,28120,26759,44430,33186.14286
8/4/2023,5,Agency_5,Friday,22623,6045,None,1,136,28.67,88405,16621,40.29,23394,4726,19755,7993,24344,8973.571429,28668,28120,27748,33317.57143
8/5/2023,5,Agency_5,Saturday,51809,15946,Sports Event,1,136,67.76,88405,16621,18.77,22623,6045,27015,11169,27886,9656,67755,28668,38184,37542
8/6/2023,5,Agency_5,Sunday,26566,8495,None,1,136,35.06,88405,16621,36.61,51809,15946,36706,8215,26437.42857,9696,35061,67755,44921,36133.42857
8/7/2023,5,Agency_5,Monday,30588,1261,Sports Event,0,136,31.85,88405,16621,39.66,26566,8495,19328,10444,28046,8384.142857,31849,35061,29772,36430.14286
8/8/2023,5,Agency_5,Tuesday,33435,5168,Concert,0,136,38.6,88405,16621,35.5,30588,1261,22764,14035,29570.42857,7117.428571,38603,31849,36799,36687.85714
8/9/2023,5,Agency_5,Wednesday,27754,3867,Festival,1,136,31.62,88405,16621,39.25,33435,5168,18578,8181,30881.28571,6501.142857,31621,38603,26759,37382.42857
8/10/2023,5,Agency_5,Thursday,14339,3204,None,1,136,17.54,88405,16621,46.42,27754,3867,23394,4726,29587.71429,6283.714286,17543,31621,28120,35871.42857
8/11/2023,5,Agency_5,Friday,32085,21196,Concert,1,136,53.28,88405,16621,24.96,14339,3204,22623,6045,30939.42857,8448.142857,53281,17543,28668,39387.57143
8/12/2023,5,Agency_5,Saturday,20844,6961,None,0,136,27.81,88405,16621,40.54,32085,21196,51809,15946,26515.85714,7164.571429,27805,53281,67755,33680.42857
8/13/2023,5,Agency_5,Sunday,39603,11629,Festival,0,136,51.23,88405,16621,27.9,20844,6961,26566,8495,28378.28571,7612.285714,51232,27805,35061,35990.57143
8/14/2023,5,Agency_5,Monday,25495,3652,None,1,136,29.15,88405,16621,40.53,39603,11629,30588,1261,27650.71429,7953.857143,29147,51232,31849,35604.57143
8/15/2023,5,Agency_5,Tuesday,40881,14643,Concert,0,136,55.52,88405,16621,25.15,25495,3652,33435,5168,28714.42857,9307.428571,55524,29147,38603,38021.85714
8/16/2023,5,Agency_5,Wednesday,17379,5016,Festival,0,136,22.4,88405,16621,43.64,40881,14643,27754,3867,27232.28571,9471.571429,22395,55524,31621,36703.85714
8/17/2023,5,Agency_5,Thursday,36270,7306,Festival,1,136,43.58,88405,16621,32.59,17379,5016,14339,3204,30365.28571,10057.57143,43576,22395,17543,40422.85714
8/18/2023,5,Agency_5,Friday,33793,6023,Festival,0,136,39.82,88405,16621,34.72,36270,7306,32085,21196,30609.28571,7890,39816,43576,53281,38499.28571
8/19/2023,5,Agency_5,Saturday,48087,13433,None,1,136,61.52,88405,16621,22.39,33793,6023,20844,6961,34501.14286,8814.571429,61520,39816,27805,43315.71429
8/20/2023,5,Agency_5,Sunday,49285,21821,Concert,1,136,71.11,88405,16621,15.92,48087,13433,39603,11629,35884.28571,10270.57143,71106,61520,51232,46154.85714
8/21/2023,5,Agency_5,Monday,38293,6582,Festival,0,136,44.88,88405,16621,32.08,49285,21821,25495,3652,37712.57143,10689.14286,44875,71106,29147,48401.71429
8/22/2023,5,Agency_5,Tuesday,15918,5156,None,0,136,21.07,88405,16621,44.27,38293,6582,40881,14643,34146.42857,9333.857143,21074,44875,55524,43480.28571
8/23/2023,5,Agency_5,Wednesday,24308,5278,None,0,136,29.59,88405,16621,39.99,15918,5156,17379,5016,35136.28571,9371.285714,29586,21074,22395,44507.57143
8/24/2023,5,Agency_5,Thursday,18172,5769,Sports Event,0,136,23.94,88405,16621,42.71,24308,5278,36270,7306,32550.85714,9151.714286,23941,29586,43576,41702.57143
8/25/2023,5,Agency_5,Friday,19630,4848,None,0,136,24.48,88405,16621,42.63,18172,5769,33793,6023,30527.57143,8983.857143,24478,23941,39816,39511.42857
8/26/2023,5,Agency_5,Saturday,46584,4054,None,1,136,50.64,88405,16621,29.71,19630,4848,48087,13433,30312.85714,7644,50638,24478,61520,37956.85714
8/27/2023,5,Agency_5,Sunday,52713,24683,Concert,1,136,77.4,88405,16621,12.2,46584,4054,49285,21821,30802.57143,8052.857143,77396,50638,71106,38855.42857
8/28/2023,5,Agency_5,Monday,61146,9974,Festival,1,136,71.12,88405,16621,18.28,52713,24683,38293,6582,34067.28571,8537.428571,71120,77396,44875,42604.71429
8/29/2023,5,Agency_5,Tuesday,33685,10436,Sports Event,0,136,44.12,88405,16621,31.69,61146,9974,15918,5156,36605.42857,9291.714286,44121,71120,21074,45897.14286
8/30/2023,5,Agency_5,Wednesday,20977,4802,None,0,136,25.78,88405,16621,41.99,33685,10436,24308,5278,36129.57143,9223.714286,25779,44121,29586,45353.28571
8/31/2023,5,Agency_5,Thursday,28832,0,None,1,136,28.83,88405,16621,41.42,20977,4802,18172,5769,37652.42857,8399.571429,28832,25779,23941,46052
9/1/2023,5,Agency_5,Friday,45649,12499,Festival,1,136,58.15,88405,16621,24.26,28832,0,19630,4848,41369.42857,9492.571429,58148,28832,24478,50862
9/2/2023,5,Agency_5,Saturday,33996,20095,Sports Event,0,136,54.09,88405,16621,24.77,45649,12499,46584,4054,39571.14286,11784.14286,54091,58148,50638,51355.28571
9/3/2023,5,Agency_5,Sunday,19950,5450,None,0,136,25.4,88405,16621,42.05,33996,20095,52713,24683,34890.71429,9036.571429,25400,54091,77396,43927.28571
9/4/2023,5,Agency_5,Monday,29957,3335,None,0,136,33.29,88405,16621,38.52,19950,5450,61146,9974,30435.14286,8088.142857,33292,25400,71120,38523.28571
9/5/2023,5,Agency_5,Tuesday,33635,11197,Concert,1,136,44.83,88405,16621,31.18,29957,3335,33685,10436,30428,8196.857143,44832,33292,44121,38624.85714
9/6/2023,5,Agency_5,Wednesday,47195,12887,Festival,1,136,60.08,88405,16621,23.22,33635,11197,20977,4802,34173.42857,9351.857143,60082,44832,25779,43525.28571
9/7/2023,5,Agency_5,Thursday,20304,6689,Festival,0,136,26.99,88405,16621,41,47195,12887,28832,0,32955.14286,10307.42857,26993,60082,28832,43262.57143
9/8/2023,5,Agency_5,Friday,33077,11531,Festival,1,136,44.61,88405,16621,31.23,20304,6689,45649,12499,31159.14286,10169.14286,44608,26993,58148,41328.28571
9/9/2023,5,Agency_5,Saturday,39832,12897,Concert,0,136,52.73,88405,16621,26.89,33077,11531,33996,20095,31992.85714,9140.857143,52729,44608,54091,41133.71429
9/10/2023,5,Agency_5,Sunday,26018,22050,Sports Event,1,136,48.07,88405,16621,27.39,39832,12897,19950,5450,32859.71429,11512.28571,48068,52729,25400,44372
9/11/2023,5,Agency_5,Monday,41460,18490,Sports Event,1,136,59.95,88405,16621,22.16,26018,22050,29957,3335,34503,13677.28571,59950,48068,33292,48180.28571
9/12/2023,5,Agency_5,Tuesday,43329,17140,Sports Event,1,136,60.47,88405,16621,22.17,41460,18490,33635,11197,35887.85714,14526.28571,60469,59950,44832,50414.14286
9/13/2023,5,Agency_5,Wednesday,33498,13076,Sports Event,0,136,46.57,88405,16621,29.93,43329,17140,47195,12887,33931.14286,14553.28571,46574,60469,60082,48484.42857
9/14/2023,5,Agency_5,Thursday,22611,4804,None,0,136,27.41,88405,16621,41.17,33498,13076,20304,6689,34260.71429,14284,27415,46574,26993,48544.71429
9/15/2023,5,Agency_5,Friday,31362,6778,None,0,136,38.14,88405,16621,35.41,22611,4804,33077,11531,34015.71429,13605,38140,27415,44608,47620.71429
9/16/2023,5,Agency_5,Saturday,35674,4453,None,1,136,40.13,88405,16621,34.88,31362,6778,39832,12897,33421.71429,12398.71429,40127,38140,52729,45820.42857
9/17/2023,5,Agency_5,Sunday,31725,17279,Sports Event,1,136,49.01,88405,16621,27.88,35674,4453,26018,22050,34237,11717.14286,49004,40127,48068,45954.14286
9/18/2023,5,Agency_5,Monday,40417,8974,Concert,1,136,49.39,88405,16621,29.35,31725,17279,41460,18490,34088,10357.71429,49391,49004,59950,44445.71429
9/19/2023,5,Agency_5,Tuesday,31056,13900,Festival,0,136,44.96,88405,16621,30.58,40417,8974,43329,17140,32334.71429,9894.857143,44956,49391,60469,42229.57143
9/20/2023,5,Agency_5,Wednesday,45780,6466,Concert,1,136,52.25,88405,16621,28.42,31056,13900,33498,13076,34089.28571,8950.571429,52246,44956,46574,43039.85714
9/21/2023,5,Agency_5,Thursday,29163,5763,Sports Event,0,136,34.93,88405,16621,37.22,45780,6466,22611,4804,35025.28571,9087.571429,34926,52246,27415,44112.85714
9/22/2023,5,Agency_5,Friday,35218,9929,Sports Event,1,136,45.15,88405,16621,31.28,29163,5763,31362,6778,35576.14286,9537.714286,45147,34926,38140,45113.85714
9/23/2023,5,Agency_5,Saturday,21133,3235,None,0,136,24.37,88405,16621,43.01,35218,9929,35674,4453,33498.85714,9363.714286,24368,45147,40127,42862.57143
9/24/2023,5,Agency_5,Sunday,45304,11998,Festival,1,136,57.3,88405,16621,24.79,21133,3235,31725,17279,35438.71429,8609.285714,57302,24368,49004,44048
9/25/2023,5,Agency_5,Monday,5352,9105,None,0,136,14.46,88405,16621,46.79,45304,11998,40417,8974,30429.42857,8628,14457,57302,49391,39057.42857
9/26/2023,5,Agency_5,Tuesday,38164,7219,Festival,0,136,45.38,88405,16621,31.7,5352,9105,31056,13900,31444.85714,7673.571429,45383,14457,44956,39118.42857
9/27/2023,5,Agency_5,Wednesday,30141,4515,Sports Event,0,136,34.66,88405,16621,37.61,38164,7219,45780,6466,29210.71429,7394.857143,34656,45383,52246,36605.57143
9/28/2023,5,Agency_5,Thursday,55532,20929,Sports Event,1,136,76.46,88405,16621,13.42,30141,4515,29163,5763,32977.71429,9561.428571,76461,34656,34926,42539.14286
9/29/2023,5,Agency_5,Friday,31174,11979,Sports Event,0,136,43.15,88405,16621,31.86,55532,20929,35218,9929,32400,9854.285714,43153,76461,45147,42254.28571
9/30/2023,5,Agency_5,Saturday,25051,3023,None,0,136,28.07,88405,16621,41.19,31174,11979,21133,3235,32959.71429,9824,28074,43153,24368,42783.71429
10/1/2023,5,Agency_5,Sunday,41979,16283,Concert,1,136,58.26,88405,16621,23.45,25051,3023,45304,11998,32484.71429,10436.14286,58262,28074,57302,42920.85714
10/2/2023,5,Agency_5,Monday,26590,7755,Sports Event,0,136,34.35,88405,16621,37.11,41979,16283,5352,9105,35518.71429,10243.28571,34345,58262,14457,45762
10/3/2023,5,Agency_5,Tuesday,25405,6773,None,1,136,32.18,88405,16621,38.39,26590,7755,38164,7219,33696,10179.57143,32178,34345,45383,43875.57143
10/4/2023,5,Agency_5,Wednesday,30391,4892,Festival,0,136,35.28,88405,16621,37.22,25405,6773,30141,4515,33731.71429,10233.42857,35283,32178,34656,43965.14286
10/5/2023,5,Agency_5,Thursday,32007,5783,Festival,1,136,37.79,88405,16621,35.79,30391,4892,55532,20929,30371,8069.714286,37790,35283,76461,38440.71429
10/6/2023,5,Agency_5,Friday,24889,788,None,0,136,25.68,88405,16621,42.84,32007,5783,31174,11979,29473.14286,6471,25677,37790,43153,35944.14286
10/7/2023,5,Agency_5,Saturday,60294,24046,Sports Event,1,136,84.34,88405,16621,8.86,24889,788,25051,3023,34507.85714,9474.285714,84340,25677,28074,43982.14286
10/8/2023,5,Agency_5,Sunday,33280,0,Concert,0,136,33.28,88405,16621,39.2,60294,24046,41979,16283,33265.14286,7148.142857,33280,84340,58262,40413.28571
10/9/2023,5,Agency_5,Monday,35476,11592,Sports Event,1,136,47.07,88405,16621,29.98,33280,0,26590,7755,34534.57143,7696.285714,47068,33280,34345,42230.85714
10/10/2023,5,Agency_5,Tuesday,22420,6747,Sports Event,0,136,29.17,88405,16621,39.9,35476,11592,25405,6773,34108.14286,7692.571429,29167,47068,32178,41800.71429
10/11/2023,5,Agency_5,Wednesday,53917,15063,Sports Event,1,136,68.98,88405,16621,18.33,22420,6747,30391,4892,37469,9145.571429,68980,29167,35283,46614.57143
10/12/2023,5,Agency_5,Thursday,23065,3066,Festival,0,136,26.13,88405,16621,42.16,53917,15063,32007,5783,36191.57143,8757.428571,26131,68980,37790,44949
10/13/2023,5,Agency_5,Friday,27546,7774,Sports Event,0,136,35.32,88405,16621,36.62,23065,3066,24889,788,36571.14286,9755.428571,35320,26131,25677,46326.57143
10/14/2023,5,Agency_5,Saturday,35068,7150,None,1,136,42.22,88405,16621,33.3,27546,7774,60294,24046,32967.42857,7341.714286,42218,35320,84340,40309.14286
10/15/2023,5,Agency_5,Sunday,40602,19602,Sports Event,0,136,60.21,88405,16621,21.81,35068,7150,33280,0,34013.42857,10142,60204,42218,33280,44155.42857
10/16/2023,5,Agency_5,Monday,24077,4903,None,0,136,28.98,88405,16621,40.37,40602,19602,35476,11592,32385,9186.428571,28980,60204,47068,41571.42857
10/17/2023,5,Agency_5,Tuesday,28626,7286,Festival,0,136,35.91,88405,16621,36.42,24077,4903,22420,6747,33271.57143,9263.428571,35912,28980,29167,42535
10/18/2023,5,Agency_5,Wednesday,50510,8913,Sports Event,1,136,59.42,88405,16621,24.34,28626,7286,53917,15063,32784.85714,8384.857143,59423,35912,68980,41169.71429
10/19/2023,5,Agency_5,Thursday,30339,8673,Festival,0,136,39.01,88405,16621,34.6,50510,8913,23065,3066,33824,9185.857143,39012,59423,26131,43009.85714
10/20/2023,5,Agency_5,Friday,34107,5366,Concert,1,136,39.47,88405,16621,35.03,30339,8673,27546,7774,34761.28571,8841.857143,39473,39012,35320,43603.14286
10/21/2023,5,Agency_5,Saturday,50576,15089,Festival,1,136,65.67,88405,16621,19.99,34107,5366,35068,7150,36976.71429,9976,65665,39473,42218,46952.71429
10/22/2023,5,Agency_5,Sunday,52652,12165,Festival,1,136,64.82,88405,16621,21,50576,15089,40602,19602,38698.14286,8913.571429,64817,65665,60204,47611.71429
10/23/2023,5,Agency_5,Monday,26104,3246,None,0,136,29.35,88405,16621,40.51,52652,12165,24077,4903,38987.71429,8676.857143,29350,64817,28980,47664.57143
10/24/2023,5,Agency_5,Tuesday,42840,2556,Concert,0,136,45.4,88405,16621,32.63,26104,3246,28626,7286,41018.28571,8001.142857,45396,29350,35912,49019.42857
10/25/2023,5,Agency_5,Wednesday,43237,14161,Festival,1,136,57.4,88405,16621,24.31,42840,2556,50510,8913,39979.28571,8750.857143,57398,45396,59423,48730.14286
10/26/2023,5,Agency_5,Thursday,31242,13918,Festival,1,136,45.16,88405,16621,30.47,43237,14161,30339,8673,40108.28571,9500.142857,45160,57398,39012,49608.42857
10/27/2023,5,Agency_5,Friday,26397,566,None,0,136,26.96,88405,16621,42.24,31242,13918,34107,5366,39006.85714,8814.428571,26963,45160,39473,47821.28571
10/28/2023,5,Agency_5,Saturday,52680,40,Concert,1,136,52.72,88405,16621,29.47,26397,566,50576,15089,39307.42857,6664.571429,52720,26963,65665,45972
10/29/2023,5,Agency_5,Sunday,35500,25550,Concert,1,136,61.05,88405,16621,20.2,52680,40,52652,12165,36857.14286,8576.714286,61050,52720,64817,45433.85714
10/30/2023,5,Agency_5,Monday,22218,3712,None,1,136,25.93,88405,16621,42.13,35500,25550,26104,3246,36302,8643.285714,25930,61050,29350,44945.28571
10/31/2023,5,Agency_5,Tuesday,28515,15529,Concert,0,136,44.04,88405,16621,30.71,22218,3712,42840,2556,34255.57143,10496.57143,44044,25930,45396,44752.14286
11/1/2023,5,Agency_5,Wednesday,14093,4055,None,1,136,18.15,88405,16621,45.95,28515,15529,43237,14161,30092.14286,9052.857143,18148,44044,57398,39145
11/2/2023,5,Agency_5,Thursday,53599,20741,Concert,1,136,74.34,88405,16621,14.52,14093,4055,31242,13918,33286,10027.57143,74340,18148,45160,43313.57143
11/3/2023,5,Agency_5,Friday,37989,5999,Concert,1,136,43.99,88405,16621,32.64,53599,20741,26397,566,34942,10803.71429,43988,74340,26963,45745.71429
11/4/2023,5,Agency_5,Saturday,47547,14902,None,1,136,62.45,88405,16621,21.63,37989,5999,52680,40,34208.71429,12926.85714,62449,43988,52720,47135.57143
11/5/2023,5,Agency_5,Sunday,28072,4387,None,0,136,32.46,88405,16621,38.73,47547,14902,35500,25550,33147.57143,9903.571429,32459,62449,61050,43051.14286
11/6/2023,5,Agency_5,Monday,38520,11136,Sports Event,1,136,49.66,88405,16621,28.78,28072,4387,22218,3712,35476.42857,10964.14286,49656,32459,25930,46440.57143
11/7/2023,5,Agency_5,Tuesday,42225,18806,Concert,1,136,61.03,88405,16621,21.56,38520,11136,28515,15529,37435,11432.28571,61031,49656,44044,48867.28571
11/8/2023,5,Agency_5,Wednesday,24397,2845,None,0,136,27.24,88405,16621,41.65,42225,18806,14093,4055,38907,11259.42857,27242,61031,18148,50166.42857
11/9/2023,5,Agency_5,Thursday,52419,13389,Sports Event,1,136,65.81,88405,16621,20.25,24397,2845,53599,20741,38738.42857,10209.14286,65808,27242,74340,48947.57143
11/10/2023,5,Agency_5,Friday,35152,13486,Concert,0,136,48.64,88405,16621,28.82,52419,13389,37989,5999,38333.14286,11278.71429,48638,65808,43988,49611.85714
11/11/2023,5,Agency_5,Saturday,25995,10890,Concert,0,136,36.89,88405,16621,35.22,35152,13486,47547,14902,35254.28571,10705.57143,36885,48638,62449,45959.85714
11/12/2023,5,Agency_5,Sunday,40580,5767,Sports Event,1,136,46.35,88405,16621,31.51,25995,10890,28072,4387,37041.14286,10902.71429,46347,36885,32459,47943.85714
11/13/2023,5,Agency_5,Monday,42379,23854,Sports Event,1,136,66.23,88405,16621,17.95,40580,5767,38520,11136,37592.42857,12719.57143,66233,46347,49656,50312
11/14/2023,5,Agency_5,Tuesday,21058,11745,Concert,1,136,32.8,88405,16621,37.09,42379,23854,42225,18806,34568.57143,11710.85714,32803,66233,61031,46279.42857
11/15/2023,5,Agency_5,Wednesday,45243,12485,Sports Event,1,136,57.73,88405,16621,24.48,21058,11745,24397,2845,37546.57143,13088,57728,32803,27242,50634.57143
11/16/2023,5,Agency_5,Thursday,37896,5714,Festival,1,136,43.61,88405,16621,32.89,45243,12485,52419,13389,35471.85714,11991.57143,43610,57728,65808,47463.42857
11/17/2023,5,Agency_5,Friday,31744,5926,Concert,0,136,37.67,88405,16621,35.82,37896,5714,35152,13486,34985,10911.57143,37670,43610,48638,45896.57143
11/18/2023,5,Agency_5,Saturday,21177,22861,Sports Event,1,136,44.04,88405,16621,29.25,31744,5926,25995,10890,34296.71429,12621.71429,44038,37670,36885,46918.42857
11/19/2023,5,Agency_5,Sunday,44623,11277,Festival,0,136,55.9,88405,16621,25.63,21177,22861,40580,5767,34874.28571,13408.85714,55900,44038,46347,48283.14286
11/20/2023,5,Agency_5,Monday,31717,12151,Concert,0,136,43.87,88405,16621,31.47,44623,11277,42379,23854,33351.14286,11737,43868,55900,66233,45088.14286
11/21/2023,5,Agency_5,Tuesday,41185,16203,Festival,1,136,57.39,88405,16621,23.9,31717,12151,21058,11745,36226.42857,12373.85714,57388,43868,32803,48600.28571
11/22/2023,5,Agency_5,Wednesday,27768,12959,Concert,0,136,40.73,88405,16621,32.88,41185,16203,45243,12485,33730,12441.57143,40727,57388,57728,46171.57143
11/23/2023,5,Agency_5,Thursday,32404,9159,Festival,0,136,41.56,88405,16621,33.22,27768,12959,37896,5714,32945.42857,12933.71429,41563,40727,43610,45879.14286
11/24/2023,5,Agency_5,Friday,26615,13263,Festival,1,136,39.88,88405,16621,33.24,32404,9159,31744,5926,32212.71429,13981.85714,39878,41563,37670,46194.57143
11/25/2023,5,Agency_5,Saturday,37065,11518,Sports Event,1,136,48.58,88405,16621,29.24,26615,13263,21177,22861,34482.42857,12361.42857,48583,39878,44038,46843.85714
11/26/2023,5,Agency_5,Sunday,28661,6336,Sports Event,0,136,35,88405,16621,37.07,37065,11518,44623,11277,32202.14286,11655.57143,34997,48583,55900,43857.71429
11/27/2023,5,Agency_5,Monday,30623,7662,None,0,136,38.29,88405,16621,35.16,28661,6336,31717,12151,32045.85714,11014.28571,38285,34997,43868,43060.14286
11/28/2023,5,Agency_5,Tuesday,44401,4341,Sports Event,0,136,48.74,88405,16621,30.6,30623,7662,41185,16203,32505.28571,9319.714286,48742,38285,57388,41825
11/29/2023,5,Agency_5,Wednesday,20356,2412,None,0,136,22.77,88405,16621,43.97,44401,4341,27768,12959,31446.42857,7813,22768,48742,40727,39259.42857
11/30/2023,5,Agency_5,Thursday,32215,7527,Concert,1,136,39.74,88405,16621,34.46,20356,2412,32404,9159,31419.42857,7579.857143,39742,22768,41563,38999.28571
12/1/2023,5,Agency_5,Friday,51084,10012,Concert,1,136,61.1,88405,16621,23.29,32215,7527,26615,13263,34915,7115.428571,61096,39742,39878,42030.42857
12/2/2023,5,Agency_5,Saturday,45613,13719,Festival,0,136,59.33,88405,16621,23.43,51084,10012,37065,11518,36136.14286,7429.857143,59332,61096,48583,43566
12/3/2023,5,Agency_5,Sunday,49168,3714,None,1,136,52.88,88405,16621,28.65,45613,13719,28661,6336,39065.71429,7055.285714,52882,59332,34997,46121
12/4/2023,5,Agency_5,Monday,39444,12396,Concert,0,136,51.84,88405,16621,27.44,49168,3714,30623,7662,40325.85714,7731.571429,51840,52882,38285,48057.42857
12/5/2023,5,Agency_5,Tuesday,29509,16693,Festival,1,136,46.2,88405,16621,29.4,39444,12396,44401,4341,38198.42857,9496.142857,46202,51840,48742,47694.57143
12/6/2023,5,Agency_5,Wednesday,21680,4545,None,0,136,26.23,88405,16621,41.82,29509,16693,20356,2412,38387.57143,9800.857143,26225,46202,22768,48188.42857
12/7/2023,5,Agency_5,Thursday,23820,6053,Sports Event,0,136,29.87,88405,16621,39.69,21680,4545,32215,7527,37188.28571,9590.285714,29873,26225,39742,46778.57143
12/8/2023,5,Agency_5,Friday,45373,8501,Festival,0,136,53.88,88405,16621,27.2,23820,6053,51084,10012,36372.42857,9374.428571,53874,29873,61096,45746.85714
12/9/2023,5,Agency_5,Saturday,55949,10575,Sports Event,1,136,66.52,88405,16621,20.46,45373,8501,45613,13719,37849,8925.285714,66524,53874,59332,46774.28571
12/10/2023,5,Agency_5,Sunday,37674,22162,Sports Event,1,136,59.84,88405,16621,21.49,55949,10575,49168,3714,36207,11560.71429,59836,66524,52882,47767.71429
12/11/2023,5,Agency_5,Monday,13252,4169,None,0,136,17.42,88405,16621,46.29,37674,22162,39444,12396,32465.28571,10385.42857,17421,59836,51840,42850.71429
12/12/2023,5,Agency_5,Tuesday,30255,8877,Festival,0,136,39.13,88405,16621,34.5,13252,4169,29509,16693,32571.85714,9268.857143,39132,17421,46202,41840.71429
12/13/2023,5,Agency_5,Wednesday,28656,9844,Sports Event,0,136,38.5,88405,16621,34.62,30255,8877,21680,4545,33568.42857,10025.85714,38500,39132,26225,43594.28571
12/14/2023,5,Agency_5,Thursday,35196,10997,Festival,0,136,46.19,88405,16621,30.54,28656,9844,23820,6053,35193.57143,10732.14286,46193,38500,29873,45925.71429
12/15/2023,5,Agency_5,Friday,29386,10545,Concert,1,136,39.93,88405,16621,33.76,35196,10997,45373,8501,32909.71429,11024.14286,39931,46193,53874,43933.85714
12/16/2023,5,Agency_5,Saturday,46751,15003,Sports Event,0,136,61.76,88405,16621,21.96,29386,10545,55949,10575,31595.71429,11656.71429,61754,39931,66524,43252.42857
12/17/2023,5,Agency_5,Sunday,15762,7412,None,0,136,23.17,88405,16621,42.77,46751,15003,37674,22162,28465.42857,9549.571429,23174,61754,59836,38015
12/18/2023,5,Agency_5,Monday,15162,8658,Concert,0,136,23.82,88405,16621,42.2,15762,7412,13252,4169,28738.28571,10190.85714,23820,23174,17421,38929.14286
12/19/2023,5,Agency_5,Tuesday,44232,5276,Sports Event,0,136,49.51,88405,16621,30.03,15162,8658,30255,8877,30735,9676.428571,49508,23820,39132,40411.42857
12/20/2023,5,Agency_5,Wednesday,30864,15536,Sports Event,1,136,46.4,88405,16621,29.53,44232,5276,28656,9844,31050.42857,10489.57143,46400,49508,38500,41540
12/21/2023,5,Agency_5,Thursday,18427,6347,Festival,0,136,24.78,88405,16621,42.18,30864,15536,35196,10997,28654.85714,9825.285714,24774,46400,46193,38480.14286
12/22/2023,5,Agency_5,Friday,44814,8879,Concert,1,136,53.69,88405,16621,27.21,18427,6347,29386,10545,30858.85714,9587.285714,53693,24774,39931,40446.14286
12/23/2023,5,Agency_5,Saturday,29359,11808,None,1,136,41.17,88405,16621,32.89,44814,8879,46751,15003,28374.28571,9130.857143,41167,53693,61754,37505.14286
12/24/2023,5,Agency_5,Sunday,39792,12227,Sports Event,0,136,52.02,88405,16621,27.38,29359,11808,15762,7412,31807.14286,9818.714286,52019,41167,23174,41625.85714
12/25/2023,5,Agency_5,Monday,18304,5740,None,0,136,24.04,88405,16621,42.67,39792,12227,15162,8658,32256,9401.857143,24044,52019,23820,41657.85714
12/26/2023,5,Agency_5,Tuesday,29071,10055,Festival,0,136,39.13,88405,16621,34.26,18304,5740,44232,5276,30090.14286,10084.57143,39126,24044,49508,40174.71429
12/27/2023,5,Agency_5,Wednesday,34154,11028,Festival,1,136,45.18,88405,16621,31.04,29071,10055,30864,15536,30560.14286,9440.571429,45182,39126,46400,40000.71429
12/28/2023,5,Agency_5,Thursday,22575,8379,Festival,0,136,30.95,88405,16621,38.68,34154,11028,18427,6347,31152.71429,9730.857143,30954,45182,24774,40883.57143
12/29/2023,5,Agency_5,Friday,23916,4710,Festival,0,136,28.63,88405,16621,40.58,22575,8379,44814,8879,28167.28571,9135.285714,28626,30954,53693,37302.57143
12/30/2023,5,Agency_5,Saturday,38327,11989,Concert,0,136,50.32,88405,16621,28.28,23916,4710,29359,11808,29448.42857,9161.142857,50316,28626,41167,38609.57143
12/31/2023,5,Agency_5,Sunday,55958,12799,Concert,1,136,68.76,88405,16621,18.9,38327,11989,39792,12227,31757.85714,9242.857143,68757,50316,52019,41000.71429
1/8/2023,6,Agency_6,Sunday,46733,5489,Concert,0,153,52.22,85591,45195,47.22,51166,17400,34382,11103,38502.42857,10022,52222,68566,45485,48524.42857
1/9/2023,6,Agency_6,Monday,30752,8652,None,1,153,39.4,85591,45195,53,46733,5489,33334,5691,38133.57143,10445,39404,52222,39025,48578.57143
1/10/2023,6,Agency_6,Tuesday,28933,9650,Sports Event,0,153,38.58,85591,45195,53.21,30752,8652,40454,13632,36487.71429,9876.142857,38583,39404,54086,46363.85714
1/11/2023,6,Agency_6,Wednesday,49036,16050,Sports Event,1,153,65.09,85591,45195,38.68,28933,9650,39068,1968,37911.71429,11887.85714,65086,38583,41036,49799.57143
1/12/2023,6,Agency_6,Thursday,21426,11288,Festival,0,153,32.71,85591,45195,55.82,49036,16050,40563,22431,35177.85714,10296,32714,65086,62994,45473.85714
1/13/2023,6,Agency_6,Friday,38368,12245,Festival,1,153,50.61,85591,45195,46.68,21426,11288,18199,3543,38059.14286,11539.14286,50613,32714,21742,49598.28571
1/14/2023,6,Agency_6,Saturday,36657,10384,Sports Event,0,153,47.04,85591,45195,48.83,38368,12245,51166,17400,35986.42857,10536.85714,47041,50613,68566,46523.28571
1/15/2023,6,Agency_6,Sunday,46724,10678,Festival,0,153,57.4,85591,45195,43.59,36657,10384,46733,5489,35985.14286,11278.14286,57402,47041,52222,47263.28571
1/16/2023,6,Agency_6,Monday,21603,7160,Festival,0,153,28.76,85591,45195,58.62,46724,10678,30752,8652,34678.14286,11065,28763,57402,39404,45743.14286
1/17/2023,6,Agency_6,Tuesday,20893,7458,None,0,153,28.35,85591,45195,58.76,21603,7160,28933,9650,33529.57143,10751.85714,28351,28763,38583,44281.42857
1/18/2023,6,Agency_6,Wednesday,23015,3298,None,0,153,26.31,85591,45195,60.62,20893,7458,49036,16050,29812.28571,8930.142857,26313,28351,65086,38742.42857
1/19/2023,6,Agency_6,Thursday,48637,9399,Concert,0,153,58.04,85591,45195,43.53,23015,3298,21426,11288,33699.57143,8660.285714,58036,26313,32714,42359.85714
1/20/2023,6,Agency_6,Friday,39564,7983,Sports Event,0,153,47.55,85591,45195,49.06,48637,9399,38368,12245,33870.42857,8051.428571,47547,58036,50613,41921.85714
1/21/2023,6,Agency_6,Saturday,53038,20661,Concert,1,153,73.7,85591,45195,33.45,39564,7983,36657,10384,36210.57143,9519.571429,73699,47547,47041,45730.14286
1/22/2023,6,Agency_6,Sunday,31308,9248,None,0,153,40.56,85591,45195,52.3,53038,20661,46724,10678,34008.28571,9315.285714,40556,73699,57402,43323.57143
1/23/2023,6,Agency_6,Monday,31668,6116,None,1,153,37.78,85591,45195,54.32,31308,9248,21603,7160,35446.14286,9166.142857,37784,40556,28763,44612.28571
1/24/2023,6,Agency_6,Tuesday,25711,9630,Festival,0,153,35.34,85591,45195,54.83,31668,6116,20893,7458,36134.42857,9476.428571,35341,37784,28351,45610.85714
1/25/2023,6,Agency_6,Wednesday,24665,4554,None,0,153,29.22,85591,45195,58.91,25711,9630,23015,3298,36370.14286,9655.857143,29219,35341,26313,46026
1/26/2023,6,Agency_6,Thursday,25325,7905,None,0,153,33.23,85591,45195,56.24,24665,4554,48637,9399,33039.85714,9442.428571,33230,29219,58036,42482.28571
1/27/2023,6,Agency_6,Friday,23127,5654,Festival,0,153,28.78,85591,45195,58.91,25325,7905,39564,7983,30691.71429,9109.714286,28781,33230,47547,39801.42857
1/28/2023,6,Agency_6,Saturday,45157,17372,Concert,1,153,62.53,85591,45195,39.69,23127,5654,53038,20661,29565.85714,8639.857143,62529,28781,73699,38205.71429
1/29/2023,6,Agency_6,Sunday,40662,23836,Sports Event,1,153,64.5,85591,45195,37.42,45157,17372,31308,9248,30902.14286,10723.85714,64498,62529,40556,41626
1/30/2023,6,Agency_6,Monday,43134,12085,Sports Event,1,153,55.22,85591,45195,44.41,40662,23836,31668,6116,32540.14286,11576.57143,55219,64498,37784,44116.71429
1/31/2023,6,Agency_6,Tuesday,24999,5635,Sports Event,1,153,30.63,85591,45195,57.99,43134,12085,25711,9630,32438.42857,11005.85714,30634,55219,35341,43444.28571
2/1/2023,6,Agency_6,Wednesday,27826,1027,None,1,153,28.85,85591,45195,59.8,24999,5635,24665,4554,32890,10502,28853,30634,29219,43392
2/2/2023,6,Agency_6,Thursday,25063,4683,None,0,153,29.75,85591,45195,58.62,27826,1027,25325,7905,32852.57143,10041.71429,29746,28853,33230,42894.28571
2/3/2023,6,Agency_6,Friday,36215,9615,None,0,153,45.83,85591,45195,49.59,25063,4683,23127,5654,34722.28571,10607.57143,45830,29746,28781,45329.85714
2/4/2023,6,Agency_6,Saturday,29783,8712,None,1,153,38.5,85591,45195,53.44,36215,9615,45157,17372,32526,9370.428571,38495,45830,62529,41896.42857
2/5/2023,6,Agency_6,Sunday,38964,15298,None,1,153,54.26,85591,45195,44.24,29783,8712,40662,23836,32283.42857,8150.714286,54262,38495,64498,40434.14286
2/6/2023,6,Agency_6,Monday,17713,2425,Festival,0,153,20.14,85591,45195,63.88,38964,15298,43134,12085,28651.85714,6770.714286,20138,54262,55219,35422.57143
2/7/2023,6,Agency_6,Tuesday,32933,14672,Festival,1,153,47.61,85591,45195,47.69,17713,2425,24999,5635,29785.28571,8061.714286,47605,20138,30634,37847
2/8/2023,6,Agency_6,Wednesday,43843,16990,Sports Event,1,153,60.83,85591,45195,40.62,32933,14672,27826,1027,32073.42857,10342.14286,60833,47605,28853,42415.57143
2/9/2023,6,Agency_6,Thursday,18201,513,None,1,153,18.72,85591,45195,64.97,43843,16990,25063,4683,31093.14286,9746.428571,18714,60833,29746,40839.57143
2/10/2023,6,Agency_6,Friday,36435,5683,Concert,0,153,42.12,85591,45195,52.24,18201,513,36215,9615,31124.57143,9184.714286,42118,18714,45830,40309.28571
2/11/2023,6,Agency_6,Saturday,23182,16367,Concert,1,153,39.55,85591,45195,51.38,36435,5683,29783,8712,30181.57143,10278.28571,39549,42118,38495,40459.85714
2/12/2023,6,Agency_6,Sunday,43137,10508,Festival,0,153,53.65,85591,45195,45.51,23182,16367,38964,15298,30777.71429,9594,53645,39549,54262,40371.71429
2/13/2023,6,Agency_6,Monday,34534,11140,Festival,1,153,45.68,85591,45195,49.37,43137,10508,17713,2425,33180.71429,10839,45674,53645,20138,44019.71429
2/14/2023,6,Agency_6,Tuesday,18147,2303,None,0,153,20.45,85591,45195,63.75,34534,11140,32933,14672,31068.42857,9072,20450,45674,47605,40140.42857
2/15/2023,6,Agency_6,Wednesday,16426,6042,None,0,153,22.47,85591,45195,61.99,18147,2303,43843,16990,27151.71429,7508,22468,20450,60833,34659.71429
2/16/2023,6,Agency_6,Thursday,28090,7470,None,1,153,35.56,85591,45195,55.16,16426,6042,18201,513,28564.42857,8501.857143,35560,22468,18714,37066.28571
2/17/2023,6,Agency_6,Friday,19531,6490,None,1,153,26.02,85591,45195,60.12,28090,7470,36435,5683,26149.57143,8617.142857,26021,35560,42118,34766.71429
2/18/2023,6,Agency_6,Saturday,21326,16571,Concert,1,153,37.9,85591,45195,52.17,19531,6490,23182,16367,25884.42857,8646.285714,37897,26021,39549,34530.71429
2/19/2023,6,Agency_6,Sunday,63516,6345,Concert,1,153,69.86,85591,45195,38.23,21326,16571,43137,10508,28795.71429,8051.571429,69861,37897,53645,36847.28571
2/20/2023,6,Agency_6,Monday,25605,9618,Concert,0,153,35.22,85591,45195,54.9,63516,6345,34534,11140,27520.14286,7834.142857,35223,69861,45674,35354.28571
2/21/2023,6,Agency_6,Tuesday,39396,6975,Concert,0,153,46.37,85591,45195,49.85,25605,9618,18147,2303,30555.71429,8501.571429,46371,35223,20450,39057.28571
2/22/2023,6,Agency_6,Wednesday,24807,1805,Festival,0,153,26.61,85591,45195,60.76,39396,6975,16426,6042,31753,7896.285714,26612,46371,22468,39649.28571
2/23/2023,6,Agency_6,Thursday,20517,9084,None,0,153,29.6,85591,45195,57.81,24807,1805,28090,7470,30671.14286,8126.857143,29601,26612,35560,38798
2/24/2023,6,Agency_6,Friday,27801,6937,None,1,153,34.74,85591,45195,55.68,20517,9084,19531,6490,31852.57143,8190.714286,34738,29601,26021,40043.28571
2/25/2023,6,Agency_6,Saturday,33711,9058,None,1,153,42.77,85591,45195,51.24,27801,6937,21326,16571,33621.85714,7117.428571,42769,34738,37897,40739.28571
2/26/2023,6,Agency_6,Sunday,24857,12095,None,1,153,36.95,85591,45195,53.54,33711,9058,63516,6345,28099.14286,7938.857143,36952,42769,69861,36038
2/27/2023,6,Agency_6,Monday,21128,5035,None,0,153,26.16,85591,45195,60.34,24857,12095,25605,9618,27459.57143,7284.142857,26163,36952,35223,34743.71429
2/28/2023,6,Agency_6,Tuesday,29489,18104,Sports Event,1,153,47.59,85591,45195,47.01,21128,5035,39396,6975,26044.28571,8874,47593,26163,46371,34918.28571
3/1/2023,6,Agency_6,Wednesday,34984,6619,Festival,0,153,41.6,85591,45195,52.31,29489,18104,24807,1805,27498.14286,9561.714286,41603,47593,26612,37059.85714
3/2/2023,6,Agency_6,Thursday,37513,6806,Concert,0,153,44.32,85591,45195,50.91,34984,6619,20517,9084,29926.14286,9236.285714,44319,41603,29601,39162.42857
3/3/2023,6,Agency_6,Friday,24133,5916,Festival,0,153,30.05,85591,45195,58.22,37513,6806,27801,6937,29402.14286,9090.428571,30049,44319,34738,38492.57143
3/4/2023,6,Agency_6,Saturday,26076,18387,Concert,1,153,44.46,85591,45195,48.52,24133,5916,33711,9058,28311.42857,10423.14286,44463,30049,42769,38734.57143
3/5/2023,6,Agency_6,Sunday,25374,7868,Sports Event,1,153,33.24,85591,45195,56.24,26076,18387,24857,12095,28385.28571,9819.285714,33242,44463,36952,38204.57143
3/6/2023,6,Agency_6,Monday,18762,11488,Festival,1,153,30.25,85591,45195,57.01,25374,7868,21128,5035,28047.28571,10741.14286,30250,33242,26163,38788.42857
3/7/2023,6,Agency_6,Tuesday,37533,10343,Concert,1,153,47.88,85591,45195,48.42,18762,11488,29489,18104,29196.42857,9632.428571,47876,30250,47593,38828.85714
3/8/2023,6,Agency_6,Wednesday,28834,6318,Festival,1,153,35.15,85591,45195,55.59,37533,10343,34984,6619,28317.85714,9589.428571,35152,47876,41603,37907.28571
3/9/2023,6,Agency_6,Thursday,33481,6626,Concert,0,153,40.11,85591,45195,53.05,28834,6318,37513,6806,27741.85714,9563.714286,40107,35152,44319,37305.57143
3/10/2023,6,Agency_6,Friday,32371,5489,Festival,0,153,37.86,85591,45195,54.4,33481,6626,24133,5916,28918.71429,9502.714286,37860,40107,30049,38421.42857
3/11/2023,6,Agency_6,Saturday,48917,23532,Concert,1,153,72.45,85591,45195,33.5,32371,5489,26076,18387,32181.71429,10237.71429,72449,37860,44463,42419.42857
3/12/2023,6,Agency_6,Sunday,53656,12917,Festival,1,153,66.57,85591,45195,38.56,48917,23532,25374,7868,36222,10959,66573,72449,33242,47181
3/13/2023,6,Agency_6,Monday,41505,10752,Concert,1,153,52.26,85591,45195,46.15,53656,12917,18762,11488,39471,10853.85714,52257,66573,30250,50324.85714
3/14/2023,6,Agency_6,Tuesday,39076,10348,Sports Event,1,153,49.42,85591,45195,47.65,41505,10752,37533,10343,39691.42857,10854.57143,49424,52257,47876,50546
3/15/2023,6,Agency_6,Wednesday,37397,12909,Sports Event,1,153,50.31,85591,45195,46.7,39076,10348,28834,6318,40914.71429,11796.14286,50306,49424,35152,52710.85714
3/16/2023,6,Agency_6,Thursday,29314,7063,Festival,1,153,36.38,85591,45195,54.83,37397,12909,33481,6626,40319.42857,11858.57143,36377,50306,40107,52178
3/17/2023,6,Agency_6,Friday,13057,1799,None,0,153,14.86,85591,45195,66.64,29314,7063,32371,5489,37560.28571,11331.42857,14856,36377,37860,48891.71429
3/18/2023,6,Agency_6,Saturday,21704,9678,None,1,153,31.38,85591,45195,56.8,13057,1799,48917,23532,33672.71429,9352.285714,31382,14856,72449,43025
3/19/2023,6,Agency_6,Sunday,27964,13319,Concert,0,153,41.28,85591,45195,51.13,21704,9678,53656,12917,30002.42857,9409.714286,41283,31382,66573,39412.14286
3/20/2023,6,Agency_6,Monday,30259,1805,Festival,0,153,32.06,85591,45195,58.04,27964,13319,41505,10752,28395.85714,8131.571429,32064,41283,52257,36527.42857
3/21/2023,6,Agency_6,Tuesday,23274,6621,None,0,153,29.89,85591,45195,58.16,30259,1805,39076,10348,26138.42857,7599.142857,29895,32064,49424,33737.57143
3/22/2023,6,Agency_6,Wednesday,19539,8175,None,1,153,27.71,85591,45195,58.94,23274,6621,37397,12909,23587.28571,6922.857143,27714,29895,50306,30510.14286
3/23/2023,6,Agency_6,Thursday,23575,8831,Concert,0,153,32.41,85591,45195,56.46,19539,8175,29314,7063,22767.42857,7175.428571,32406,27714,36377,29942.85714
3/24/2023,6,Agency_6,Friday,26670,3362,Festival,1,153,30.03,85591,45195,58.74,23575,8831,13057,1799,24712.14286,7398.714286,30032,32406,14856,32110.85714
3/25/2023,6,Agency_6,Saturday,42318,14702,Concert,1,153,57.02,85591,45195,42.98,26670,3362,21704,9678,27657,8116.428571,57020,30032,31382,35773.42857
3/26/2023,6,Agency_6,Sunday,32419,5814,Sports Event,0,153,38.23,85591,45195,54.15,42318,14702,27964,13319,28293.42857,7044.285714,38233,57020,41283,35337.71429
3/27/2023,6,Agency_6,Monday,27000,9414,Festival,0,153,36.41,85591,45195,54.34,32419,5814,30259,1805,27827.85714,8131.285714,36414,38233,32064,35959.14286
3/28/2023,6,Agency_6,Tuesday,29662,9120,Sports Event,0,153,38.78,85591,45195,53.22,27000,9414,23274,6621,28740.42857,8488.285714,38782,36414,29895,37228.71429
3/29/2023,6,Agency_6,Wednesday,32465,17476,Sports Event,1,153,49.94,85591,45195,45.97,29662,9120,19539,8175,30587,9817,49941,38782,27714,40404
3/30/2023,6,Agency_6,Thursday,14119,5975,None,0,153,20.09,85591,45195,63.19,32465,17476,23575,8831,29236.14286,9409,20094,49941,32406,38645.14286
3/31/2023,6,Agency_6,Friday,38863,10133,Concert,0,153,49,85591,45195,47.91,14119,5975,26670,3362,30978,10376.28571,48996,20094,30032,41354.28571
4/1/2023,6,Agency_6,Saturday,34176,8714,Sports Event,0,153,42.89,85591,45195,51.24,38863,10133,42318,14702,29814.85714,9520.857143,42890,48996,57020,39335.71429
4/2/2023,6,Agency_6,Sunday,45324,4760,Concert,0,153,50.08,85591,45195,48.44,34176,8714,32419,5814,31658.42857,9370.285714,50084,42890,38233,41028.71429
4/3/2023,6,Agency_6,Monday,29540,10005,Sports Event,1,153,39.55,85591,45195,52.66,45324,4760,27000,9414,32021.28571,9454.714286,39545,50084,36414,41476
4/4/2023,6,Agency_6,Tuesday,26188,5759,None,0,153,31.95,85591,45195,57.31,29540,10005,29662,9120,31525,8974.571429,31947,39545,38782,40499.57143
4/5/2023,6,Agency_6,Wednesday,22738,7444,Sports Event,0,153,30.18,85591,45195,57.85,26188,5759,32465,17476,30135.42857,7541.428571,30182,31947,49941,37676.85714
4/6/2023,6,Agency_6,Thursday,22006,5012,None,1,153,27.02,85591,45195,59.92,22738,7444,14119,5975,31262.14286,7403.857143,27018,30182,20094,38666
4/7/2023,6,Agency_6,Friday,37341,3835,Festival,0,153,41.18,85591,45195,53.08,22006,5012,38863,10133,31044.71429,6504.142857,41176,27018,48996,37548.85714
4/8/2023,6,Agency_6,Saturday,33651,8652,None,0,153,42.3,85591,45195,51.55,37341,3835,34176,8714,30969.71429,6495.285714,42303,41176,42890,37465
4/9/2023,6,Agency_6,Sunday,59562,12604,Festival,1,153,72.17,85591,45195,35.83,33651,8652,45324,4760,33003.71429,7615.857143,72166,42303,50084,40619.57143
4/10/2023,6,Agency_6,Monday,37537,5076,Sports Event,1,153,42.61,85591,45195,52.11,59562,12604,29540,10005,34146.14286,6911.714286,42613,72166,39545,41057.85714
4/11/2023,6,Agency_6,Tuesday,17376,5987,None,0,153,23.36,85591,45195,61.55,37537,5076,26188,5759,32887.28571,6944.285714,23363,42613,31947,39831.57143
4/12/2023,6,Agency_6,Wednesday,39720,4734,Festival,0,153,44.45,85591,45195,51.26,17376,5987,22738,7444,35313.28571,6557.142857,44454,23363,30182,41870.42857
4/13/2023,6,Agency_6,Thursday,35435,11178,Festival,1,153,46.61,85591,45195,48.89,39720,4734,22006,5012,37231.71429,7438,46613,44454,27018,44669.71429
4/14/2023,6,Agency_6,Friday,25390,14713,Concert,1,153,40.1,85591,45195,51.44,35435,11178,37341,3835,35524.42857,8992,40103,46613,41176,44516.42857
4/15/2023,6,Agency_6,Saturday,38329,14260,Sports Event,1,153,52.59,85591,45195,45.29,25390,14713,33651,8652,36192.71429,9793.142857,52589,40103,42303,45985.85714
4/16/2023,6,Agency_6,Sunday,27674,6226,None,1,153,33.9,85591,45195,56.24,38329,14260,59562,12604,31637.28571,8882,33900,52589,72166,40519.28571
4/17/2023,6,Agency_6,Monday,29946,7765,Sports Event,0,153,37.71,85591,45195,54.02,27674,6226,37537,5076,30552.85714,9266.142857,37711,33900,42613,39819
4/18/2023,6,Agency_6,Tuesday,35373,8432,Sports Event,1,153,43.81,85591,45195,50.84,29946,7765,17376,5987,33123.85714,9615.428571,43805,37711,23363,42739.28571
4/19/2023,6,Agency_6,Wednesday,42114,19770,Festival,1,153,61.88,85591,45195,39.54,35373,8432,39720,4734,33465.85714,11763.42857,61884,43805,44454,45229.28571
4/20/2023,6,Agency_6,Thursday,31048,11886,Sports Event,0,153,42.93,85591,45195,50.59,42114,19770,35435,11178,32839.14286,11864.57143,42934,61884,46613,44703.71429
4/21/2023,6,Agency_6,Friday,25443,12649,Concert,1,153,38.09,85591,45195,52.86,31048,11886,25390,14713,32846.71429,11569.71429,38092,42934,40103,44416.42857
4/22/2023,6,Agency_6,Saturday,26123,4521,Concert,0,153,30.65,85591,45195,58.21,25443,12649,38329,14260,31103,10178.42857,30644,38092,52589,41281.42857
4/23/2023,6,Agency_6,Sunday,25432,13437,None,1,153,38.87,85591,45195,52.31,26123,4521,27674,6226,30782.71429,11208.57143,38869,30644,33900,41991.28571
4/24/2023,6,Agency_6,Monday,37125,9326,Concert,0,153,46.45,85591,45195,49.34,25432,13437,29946,7765,31808.28571,11431.57143,46451,38869,37711,43239.85714
4/25/2023,6,Agency_6,Tuesday,18504,7831,Concert,0,153,26.34,85591,45195,59.7,37125,9326,35373,8432,29398.42857,11345.71429,26335,46451,43805,40744.14286
4/26/2023,6,Agency_6,Wednesday,32262,9096,Festival,0,153,41.36,85591,45195,51.93,18504,7831,42114,19770,27991,9820.857143,41358,26335,61884,37811.85714
4/27/2023,6,Agency_6,Thursday,21022,7661,Concert,1,153,28.68,85591,45195,58.56,32262,9096,31048,11886,26558.71429,9217.285714,28683,41358,42934,35776
4/28/2023,6,Agency_6,Friday,29518,10322,Festival,0,153,39.84,85591,45195,52.45,21022,7661,25443,12649,27140.85714,8884.857143,39840,28683,38092,36025.71429
4/29/2023,6,Agency_6,Saturday,21104,14464,Sports Event,1,153,35.57,85591,45195,53.75,29518,10322,26123,4521,26423.85714,10305.28571,35568,39840,30644,36729.14286
4/30/2023,6,Agency_6,Sunday,37287,14804,Sports Event,0,153,52.09,85591,45195,45.43,21104,14464,25432,13437,28117.42857,10500.57143,52091,35568,38869,38618
5/1/2023,6,Agency_6,Monday,45754,14672,Concert,1,153,60.43,85591,45195,41.28,37287,14804,37125,9326,29350.14286,11264.28571,60426,52091,46451,40614.42857
5/2/2023,6,Agency_6,Tuesday,16000,1183,None,0,153,17.18,85591,45195,65.6,45754,14672,18504,7831,28992.42857,10314.57143,17183,60426,26335,39307
5/3/2023,6,Agency_6,Wednesday,18034,7003,None,0,153,25.04,85591,45195,60.51,16000,1183,32262,9096,26959.85714,10015.57143,25037,17183,41358,36975.42857
5/4/2023,6,Agency_6,Thursday,40450,10915,Concert,0,153,51.37,85591,45195,46.57,18034,7003,21022,7661,29735.28571,10480.42857,51365,25037,28683,40215.71429
5/5/2023,6,Agency_6,Friday,22146,5759,None,0,153,27.91,85591,45195,59.33,40450,10915,29518,10322,28682.14286,9828.571429,27905,51365,39840,38510.71429
5/6/2023,6,Agency_6,Saturday,20662,6160,None,0,153,26.82,85591,45195,59.79,22146,5759,21104,14464,28619,8642.285714,26822,27905,35568,37261.28571
5/7/2023,6,Agency_6,Sunday,51021,6881,Festival,0,153,57.9,85591,45195,44.1,20662,6160,37287,14804,30581,7510.428571,57902,26822,52091,38091.42857
5/8/2023,6,Agency_6,Monday,42109,7403,Sports Event,0,153,49.51,85591,45195,48.19,51021,6881,45754,14672,30060.28571,6472,49512,57902,60426,36532.28571
5/9/2023,6,Agency_6,Tuesday,39940,3716,Festival,0,153,43.66,85591,45195,51.86,42109,7403,16000,1183,33480.28571,6833.857143,43656,49512,17183,40314.14286
5/10/2023,6,Agency_6,Wednesday,44711,8391,Concert,1,153,53.1,85591,45195,46.2,39940,3716,18034,7003,37291.28571,7032.142857,53102,43656,25037,44323.42857
5/11/2023,6,Agency_6,Thursday,25199,12940,Sports Event,1,153,38.14,85591,45195,52.77,44711,8391,40450,10915,35112.57143,7321.428571,38139,53102,51365,42434
5/12/2023,6,Agency_6,Friday,37570,5627,Concert,0,153,43.2,85591,45195,51.71,25199,12940,22146,5759,37316,7302.571429,43197,38139,27905,44618.57143
5/13/2023,6,Agency_6,Saturday,22507,10643,Sports Event,0,153,33.15,85591,45195,55.73,37570,5627,20662,6160,37579.57143,7943,33150,43197,26822,45522.57143
5/14/2023,6,Agency_6,Sunday,45775,18861,Concert,1,153,64.64,85591,45195,38.34,22507,10643,51021,6881,36830.14286,9654.428571,64636,33150,57902,46484.57143
5/15/2023,6,Agency_6,Monday,48256,11616,Concert,1,153,59.87,85591,45195,42.17,45775,18861,42109,7403,37708.28571,10256.28571,59872,64636,49512,47964.57143
5/16/2023,6,Agency_6,Tuesday,43915,9261,Sports Event,0,153,53.18,85591,45195,45.99,48256,11616,39940,3716,38276.14286,11048.42857,53176,59872,43656,49324.57143
5/17/2023,6,Agency_6,Wednesday,35620,4226,Concert,1,153,39.85,85591,45195,53.66,43915,9261,44711,8391,36977.42857,10453.42857,39846,53176,53102,47430.85714
5/18/2023,6,Agency_6,Thursday,28029,7355,Sports Event,0,153,35.38,85591,45195,55.27,35620,4226,25199,12940,37381.71429,9655.571429,35384,39846,38139,47037.28571
5/19/2023,6,Agency_6,Friday,24801,5924,None,0,153,30.73,85591,45195,57.88,28029,7355,37570,5627,35557.57143,9698,30725,35384,43197,45255.57143
5/20/2023,6,Agency_6,Saturday,33001,16534,Concert,1,153,49.54,85591,45195,46.36,24801,5924,22507,10643,37056.71429,10539.57143,49535,30725,33150,47596.28571
5/21/2023,6,Agency_6,Sunday,42042,17803,Concert,0,153,59.85,85591,45195,40.95,33001,16534,45775,18861,36523.42857,10388.42857,59845,49535,64636,46911.85714
5/22/2023,6,Agency_6,Monday,47652,15519,Concert,1,153,63.17,85591,45195,39.74,42042,17803,48256,11616,36437.14286,10946,63171,59845,59872,47383.14286
5/23/2023,6,Agency_6,Tuesday,20300,5776,None,0,153,26.08,85591,45195,60.24,47652,15519,43915,9261,33063.57143,10448.14286,26076,63171,53176,43511.71429
5/24/2023,6,Agency_6,Wednesday,34121,3267,None,1,153,37.39,85591,45195,55.08,20300,5776,35620,4226,32849.42857,10311.14286,37388,26076,39846,43160.57143
5/25/2023,6,Agency_6,Thursday,27378,5871,Concert,0,153,33.25,85591,45195,56.63,34121,3267,28029,7355,32756.42857,10099.14286,33249,37388,35384,42855.57143
5/26/2023,6,Agency_6,Friday,42695,17754,Sports Event,1,153,60.45,85591,45195,40.66,27378,5871,24801,5924,35312.71429,11789.14286,60449,33249,30725,47101.85714
5/27/2023,6,Agency_6,Saturday,30627,483,Festival,0,153,31.11,85591,45195,58.78,42695,17754,33001,16534,34973.57143,9496.142857,31110,60449,49535,44469.71429
5/28/2023,6,Agency_6,Sunday,32288,15085,Sports Event,0,153,47.37,85591,45195,47.73,30627,483,42042,17803,33580.14286,9107.857143,47373,31110,59845,42688
5/29/2023,6,Agency_6,Monday,44241,13937,Sports Event,1,153,58.18,85591,45195,42.56,32288,15085,47652,15519,33092.85714,8881.857143,58178,47373,63171,41974.71429
5/30/2023,6,Agency_6,Tuesday,27900,4149,Festival,0,153,32.05,85591,45195,57.58,44241,13937,20300,5776,34178.57143,8649.428571,32049,58178,26076,42828
5/31/2023,6,Agency_6,Wednesday,33864,5662,Sports Event,0,153,39.53,85591,45195,53.54,27900,4149,34121,3267,34141.85714,8991.571429,39526,32049,37388,43133.42857
6/1/2023,6,Agency_6,Thursday,60294,14615,Festival,1,153,74.91,85591,45195,34.05,33864,5662,27378,5871,38844.14286,10240.71429,74909,39526,33249,49084.85714
6/2/2023,6,Agency_6,Friday,25644,6420,Concert,0,153,32.06,85591,45195,57.12,60294,14615,42695,17754,36408.28571,8621.571429,32064,74909,60449,45029.85714
6/3/2023,6,Agency_6,Saturday,45711,13984,Festival,1,153,59.7,85591,45195,41.79,25644,6420,30627,483,38563.14286,10550.28571,59695,32064,31110,49113.42857
6/4/2023,6,Agency_6,Sunday,46051,11872,Festival,0,153,57.92,85591,45195,43.1,45711,13984,32288,15085,40529.28571,10091.28571,57923,59695,47373,50620.57143
6/5/2023,6,Agency_6,Monday,16341,8780,None,0,153,25.12,85591,45195,60.12,46051,11872,44241,13937,36543.57143,9354.571429,25121,57923,58178,45898.14286
6/6/2023,6,Agency_6,Tuesday,20246,6537,None,0,153,26.78,85591,45195,59.73,16341,8780,27900,4149,35450.14286,9695.714286,26783,25121,32049,45145.85714
6/7/2023,6,Agency_6,Wednesday,25437,9734,Sports Event,0,153,35.17,85591,45195,54.9,20246,6537,33864,5662,34246.28571,10277.42857,35171,26783,39526,44523.71429
6/8/2023,6,Agency_6,Thursday,42032,2903,Festival,1,153,44.94,85591,45195,51.38,25437,9734,60294,14615,31637.42857,8604.285714,44935,35171,74909,40241.71429
6/9/2023,6,Agency_6,Friday,45114,12887,Festival,0,153,58,85591,45195,42.85,42032,2903,25644,6420,34418.85714,9528.142857,58001,44935,32064,43947
6/10/2023,6,Agency_6,Saturday,42152,8647,Concert,1,153,50.8,85591,45195,47.3,45114,12887,45711,13984,33910.42857,8765.714286,50799,58001,59695,42676.14286
6/11/2023,6,Agency_6,Sunday,50864,16005,Festival,1,153,66.87,85591,45195,37.8,42152,8647,46051,11872,34598,9356.142857,66869,50799,57923,43954.14286
6/12/2023,6,Agency_6,Monday,42467,12811,Sports Event,1,153,55.28,85591,45195,44.23,50864,16005,16341,8780,38330.28571,9932,55278,66869,25121,48262.28571
6/13/2023,6,Agency_6,Tuesday,43935,18787,Festival,1,153,62.72,85591,45195,39.31,42467,12811,20246,6537,41714.42857,11682,62722,55278,26783,53396.42857
6/14/2023,6,Agency_6,Wednesday,44538,6902,Concert,1,153,51.44,85591,45195,47.33,43935,18787,25437,9734,44443.14286,11277.42857,51440,62722,35171,55720.57143
6/15/2023,6,Agency_6,Thursday,40218,14077,Sports Event,0,153,54.3,85591,45195,44.47,44538,6902,42032,2903,44184,12873.71429,54295,51440,44935,57057.71429
6/16/2023,6,Agency_6,Friday,69732,6552,Festival,1,153,76.28,85591,45195,34.98,40218,14077,45114,12887,47700.85714,11968.71429,76284,54295,58001,59669.57143
6/17/2023,6,Agency_6,Saturday,49640,2583,Festival,1,153,52.22,85591,45195,47.8,69732,6552,42152,8647,48770.57143,11102.42857,52223,76284,50799,59873
6/18/2023,6,Agency_6,Sunday,53270,12075,Festival,1,153,65.35,85591,45195,39.34,49640,2583,50864,16005,49114.28571,10541,65345,52223,66869,59655.28571
6/19/2023,6,Agency_6,Monday,44425,5865,Concert,0,153,50.29,85591,45195,48.11,53270,12075,42467,12811,49394,9548.714286,50290,65345,55278,58942.71429
6/20/2023,6,Agency_6,Tuesday,22530,9655,Concert,1,153,32.19,85591,45195,56.41,44425,5865,43935,18787,46336.14286,8244.142857,32185,50290,62722,54580.28571
6/21/2023,6,Agency_6,Wednesday,15183,11053,Concert,0,153,26.24,85591,45195,59.1,22530,9655,44538,6902,42142.57143,8837.142857,26236,32185,51440,50979.71429
6/22/2023,6,Agency_6,Thursday,18864,12033,Concert,1,153,30.9,85591,45195,56.58,15183,11053,40218,14077,39092,8545.142857,30897,26236,54295,47637.14286
6/23/2023,6,Agency_6,Friday,14415,7410,Festival,0,153,21.83,85591,45195,62.04,18864,12033,69732,6552,31189.57143,8667.714286,21825,30897,76284,39857.28571
6/24/2023,6,Agency_6,Saturday,66025,17700,Concert,1,153,83.73,85591,45195,29.03,14415,7410,49640,2583,33530.28571,10827.28571,83725,21825,52223,44357.57143
6/25/2023,6,Agency_6,Sunday,18818,6418,None,0,153,25.24,85591,45195,60.53,66025,17700,53270,12075,28608.57143,10019.14286,25236,83725,65345,38627.71429
6/26/2023,6,Agency_6,Monday,39175,14149,Concert,1,153,53.32,85591,45195,44.94,18818,6418,44425,5865,27858.57143,11202.57143,53324,25236,50290,39061.14286
6/27/2023,6,Agency_6,Tuesday,19747,10514,Sports Event,0,153,30.26,85591,45195,57.2,39175,14149,22530,9655,27461,11325.28571,30261,53324,32185,38786.28571
6/28/2023,6,Agency_6,Wednesday,8421,5236,None,1,153,13.66,85591,45195,66.56,19747,10514,15183,11053,26495,10494.28571,13657,30261,26236,36989.28571
6/29/2023,6,Agency_6,Thursday,34238,14913,Concert,1,153,49.15,85591,45195,46.87,8421,5236,18864,12033,28691.28571,10905.71429,49151,13657,30897,39597
6/30/2023,6,Agency_6,Friday,20113,2188,None,0,153,22.3,85591,45195,62.84,34238,14913,14415,7410,29505.28571,10159.71429,22301,49151,21825,39665
7/1/2023,6,Agency_6,Saturday,35275,16698,Sports Event,1,153,51.97,85591,45195,45.11,20113,2188,66025,17700,25112.42857,10016.57143,51973,22301,83725,35129
7/2/2023,6,Agency_6,Sunday,35287,8488,Festival,0,153,43.78,85591,45195,50.85,35275,16698,18818,6418,27465.14286,10312.28571,43775,51973,25236,37777.42857
7/3/2023,6,Agency_6,Monday,34310,15212,Concert,1,153,49.52,85591,45195,46.63,35287,8488,39175,14149,26770.14286,10464.14286,49522,43775,53324,37234.28571
7/4/2023,6,Agency_6,Tuesday,26116,8199,Sports Event,0,153,34.32,85591,45195,55.63,34310,15212,19747,10514,27680,10133.42857,34315,49522,30261,37813.42857
7/5/2023,6,Agency_6,Wednesday,60155,5121,Concert,1,153,65.28,85591,45195,40.77,26116,8199,8421,5236,35070.57143,10117,65276,34315,13657,45187.57143
7/6/2023,6,Agency_6,Thursday,16110,11163,Concert,0,153,27.27,85591,45195,58.56,60155,5121,34238,14913,32480.85714,9581.285714,27273,65276,49151,42062.14286
7/7/2023,6,Agency_6,Friday,24909,7417,Concert,0,153,32.33,85591,45195,56.79,16110,11163,20113,2188,33166,10328.28571,32326,27273,22301,43494.28571
7/8/2023,6,Agency_6,Saturday,25106,8153,None,1,153,33.26,85591,45195,56.17,24909,7417,35275,16698,31713.28571,9107.571429,33259,32326,51973,40820.85714
7/9/2023,6,Agency_6,Sunday,50385,14594,Concert,0,153,64.98,85591,45195,39.02,25106,8153,35287,8488,33870.14286,9979.857143,64979,33259,43775,43850
7/10/2023,6,Agency_6,Monday,36466,3683,Concert,0,153,40.15,85591,45195,53.62,50385,14594,34310,15212,34178.14286,8332.857143,40149,64979,49522,42511
7/11/2023,6,Agency_6,Tuesday,27775,0,Festival,1,153,27.78,85591,45195,60.54,36466,3683,26116,8199,34415.14286,7161.571429,27775,40149,34315,41576.71429
7/12/2023,6,Agency_6,Wednesday,31108,16452,Festival,1,153,47.56,85591,45195,47.36,27775,0,60155,5121,30265.57143,8780.285714,47560,27775,65276,39045.85714
7/13/2023,6,Agency_6,Thursday,33876,7745,Sports Event,0,153,41.62,85591,45195,52.07,31108,16452,16110,11163,32803.57143,8292,41621,47560,27273,41095.57143
7/14/2023,6,Agency_6,Friday,19888,3622,None,0,153,23.51,85591,45195,61.95,33876,7745,24909,7417,32086.28571,7749.857143,23510,41621,32326,39836.14286
7/15/2023,6,Agency_6,Saturday,32795,11886,None,1,153,44.68,85591,45195,49.71,19888,3622,25106,8153,33184.71429,8283.142857,44681,23510,33259,41467.85714
7/16/2023,6,Agency_6,Sunday,27892,17323,Festival,1,153,45.22,85591,45195,48.36,32795,11886,50385,14594,29971.42857,8673,45215,44681,64979,38644.42857
7/17/2023,6,Agency_6,Monday,36993,7087,Festival,0,153,44.08,85591,45195,50.97,27892,17323,36466,3683,30046.71429,9159.285714,44080,45215,40149,39206
7/18/2023,6,Agency_6,Tuesday,45830,25297,Concert,1,153,71.13,85591,45195,33.81,36993,7087,27775,0,32626,12773.14286,71127,44080,27775,45399.14286
7/19/2023,6,Agency_6,Wednesday,29217,9836,Sports Event,0,153,39.05,85591,45195,52.94,45830,25297,31108,16452,32355.85714,11828,39053,71127,47560,44183.85714
7/20/2023,6,Agency_6,Thursday,24463,9115,Festival,0,153,33.58,85591,45195,55.82,29217,9836,33876,7745,31011.14286,12023.71429,33578,39053,41621,43034.85714
7/21/2023,6,Agency_6,Friday,33451,9161,Sports Event,0,153,42.61,85591,45195,51.29,24463,9115,19888,3622,32948.71429,12815,42612,33578,23510,45763.71429
7/22/2023,6,Agency_6,Saturday,23245,9849,None,1,153,33.1,85591,45195,55.91,33451,9161,32795,11886,31584.42857,12524,33094,42612,44681,44108.42857
7/23/2023,6,Agency_6,Sunday,49158,13032,Festival,0,153,62.19,85591,45195,40.73,23245,9849,27892,17323,34622.42857,11911,62190,33094,45215,46533.42857
7/24/2023,6,Agency_6,Monday,48377,10769,Festival,1,153,59.15,85591,45195,42.7,49158,13032,36993,7087,36248.71429,12437,59146,62190,44080,48685.71429
7/25/2023,6,Agency_6,Tuesday,46310,13228,Sports Event,1,153,59.54,85591,45195,42.02,48377,10769,45830,25297,36317.28571,10712.85714,59538,59146,71127,47030.14286
7/26/2023,6,Agency_6,Wednesday,22867,9582,Sports Event,0,153,32.45,85591,45195,56.29,46310,13228,29217,9836,35410.14286,10676.57143,32449,59538,39053,46086.71429
7/27/2023,6,Agency_6,Thursday,29329,8886,Festival,1,153,38.22,85591,45195,53.55,22867,9582,24463,9115,36105.28571,10643.85714,38215,32449,33578,46749.14286
7/28/2023,6,Agency_6,Friday,31419,9509,Sports Event,0,153,40.93,85591,45195,52.07,29329,8886,33451,9161,35815,10693.57143,40928,38215,42612,46508.57143
7/29/2023,6,Agency_6,Saturday,25295,15706,Sports Event,0,153,41,85591,45195,50.79,31419,9509,23245,9849,36107.85714,11530.28571,41001,40928,33094,47638.14286
7/30/2023,6,Agency_6,Sunday,41148,7933,Festival,0,153,49.08,85591,45195,48.3,25295,15706,49158,13032,34963.57143,10801.85714,49081,41001,62190,45765.42857
7/31/2023,6,Agency_6,Monday,18468,8007,Sports Event,0,153,26.48,85591,45195,59.59,41148,7933,48377,10769,30690.85714,10407.28571,26475,49081,59146,41098.14286
8/1/2023,6,Agency_6,Tuesday,34651,12437,Concert,1,153,47.09,85591,45195,48.4,18468,8007,46310,13228,29025.28571,10294.28571,47088,26475,59538,39319.57143
8/2/2023,6,Agency_6,Wednesday,35458,2344,Sports Event,1,153,37.8,85591,45195,55.06,34651,12437,22867,9582,30824,9260.285714,37802,47088,32449,40084.28571
8/3/2023,6,Agency_6,Thursday,23475,6143,None,1,153,29.62,85591,45195,58.39,35458,2344,29329,8886,29987.71429,8868.428571,29618,37802,38215,38856.14286
8/4/2023,6,Agency_6,Friday,45177,8575,Concert,1,153,53.75,85591,45195,45.84,23475,6143,31419,9509,31953.14286,8735,53752,29618,40928,40688.14286
8/5/2023,6,Agency_6,Saturday,44293,2140,None,1,153,46.43,85591,45195,50.79,45177,8575,25295,15706,34667.14286,6797,46433,53752,41001,41464.14286
8/6/2023,6,Agency_6,Sunday,47799,10057,Festival,0,153,57.86,85591,45195,43.49,44293,2140,41148,7933,35617.28571,7100.428571,57856,46433,49081,42717.71429
8/7/2023,6,Agency_6,Monday,47379,12278,Concert,1,153,59.66,85591,45195,42.15,47799,10057,18468,8007,39747.42857,7710.571429,59657,57856,26475,47458
8/8/2023,6,Agency_6,Tuesday,50109,10055,Festival,1,153,60.16,85591,45195,42.34,47379,12278,34651,12437,41955.71429,7370.285714,60164,59657,47088,49326
8/9/2023,6,Agency_6,Wednesday,28286,18661,Concert,1,153,46.95,85591,45195,47.23,50109,10055,35458,2344,40931.14286,9701.285714,46947,60164,37802,50632.42857
8/10/2023,6,Agency_6,Thursday,29148,9253,Concert,0,153,38.4,85591,45195,53.38,28286,18661,23475,6143,41741.57143,10145.57143,38401,46947,29618,51887.14286
8/11/2023,6,Agency_6,Friday,39259,4991,Sports Event,0,153,44.25,85591,45195,51.31,29148,9253,45177,8575,40896.14286,9633.571429,44250,38401,53752,50529.71429
8/12/2023,6,Agency_6,Saturday,41358,8442,Concert,0,153,49.8,85591,45195,47.84,39259,4991,44293,2140,40476.85714,10533.85714,49800,44250,46433,51010.71429
8/13/2023,6,Agency_6,Sunday,34810,11368,Festival,0,153,46.18,85591,45195,49.07,41358,8442,47799,10057,38621.28571,10721.14286,46178,49800,57856,49342.42857
8/14/2023,6,Agency_6,Monday,18747,5851,Concert,0,153,24.6,85591,45195,60.96,34810,11368,47379,12278,34531,9803,24598,46178,59657,44334
8/15/2023,6,Agency_6,Tuesday,52172,16117,Concert,1,153,68.29,85591,45195,37.06,18747,5851,50109,10055,34825.71429,10669,68289,24598,60164,45494.71429
8/16/2023,6,Agency_6,Wednesday,29529,9326,Concert,0,153,38.86,85591,45195,53.14,52172,16117,28286,18661,35003.28571,9335.428571,38855,68289,46947,44338.71429
8/17/2023,6,Agency_6,Thursday,18528,7713,None,0,153,26.24,85591,45195,59.77,29529,9326,29148,9253,33486.14286,9115.428571,26241,38855,38401,42601.57143
8/18/2023,6,Agency_6,Friday,28497,9287,Sports Event,0,153,37.78,85591,45195,53.68,18528,7713,39259,4991,31948.71429,9729.142857,37784,26241,44250,41677.85714
8/19/2023,6,Agency_6,Saturday,40138,6269,None,1,153,46.41,85591,45195,49.97,28497,9287,41358,8442,31774.42857,9418.714286,46407,37784,49800,41193.14286
8/20/2023,6,Agency_6,Sunday,65035,5999,Festival,1,153,71.03,85591,45195,37.71,40138,6269,34810,11368,36092.28571,8651.714286,71034,46407,46178,44744
8/21/2023,6,Agency_6,Monday,54888,10124,Sports Event,1,153,65.01,85591,45195,39.9,65035,5999,18747,5851,41255.28571,9262.142857,65012,71034,24598,50517.42857
8/22/2023,6,Agency_6,Tuesday,28179,2072,Sports Event,0,153,30.25,85591,45195,58.89,54888,10124,52172,16117,37827.71429,7255.714286,30251,65012,68289,45083.42857
8/23/2023,6,Agency_6,Wednesday,34565,6949,Festival,1,153,41.52,85591,45195,52.28,28179,2072,29529,9326,38547.14286,6916.142857,41514,30251,38855,45463.28571
8/24/2023,6,Agency_6,Thursday,25441,8032,Concert,0,153,33.47,85591,45195,56.09,34565,6949,18528,7713,39534.71429,6961.714286,33473,41514,26241,46496.42857
8/25/2023,6,Agency_6,Friday,32224,7580,None,1,153,39.81,85591,45195,53.01,25441,8032,28497,9287,40067.14286,6717.857143,39804,33473,37784,46785
8/26/2023,6,Agency_6,Saturday,38768,6205,Sports Event,0,153,44.97,85591,45195,50.7,32224,7580,40138,6269,39871.42857,6708.714286,44973,39804,46407,46580.14286
8/27/2023,6,Agency_6,Sunday,36494,26599,Festival,1,153,63.09,85591,45195,37.57,38768,6205,65035,5999,35794.14286,9651.571429,63093,44973,71034,45445.71429
8/28/2023,6,Agency_6,Monday,31829,19782,Concert,1,153,51.61,85591,45195,44.67,36494,26599,54888,10124,32500,11031.28571,51611,63093,65012,43531.28571
8/29/2023,6,Agency_6,Tuesday,24419,7005,None,1,153,31.42,85591,45195,57.32,31829,19782,28179,2072,31962.85714,11736,31424,51611,30251,43698.85714
8/30/2023,6,Agency_6,Wednesday,38026,12823,Festival,0,153,50.85,85591,45195,46.44,24419,7005,34565,6949,32457.28571,12575.14286,50849,31424,41514,45032.42857
8/31/2023,6,Agency_6,Thursday,19445,4223,None,0,153,23.67,85591,45195,61.75,38026,12823,25441,8032,31600.71429,12031,23668,50849,33473,43631.71429
9/1/2023,6,Agency_6,Friday,29580,9647,Sports Event,0,153,39.23,85591,45195,52.89,19445,4223,32224,7580,31223,12326.28571,39227,23668,39804,43549.28571
9/2/2023,6,Agency_6,Saturday,57227,15494,Festival,1,153,72.72,85591,45195,34.97,29580,9647,38768,6205,33860,13653.28571,72721,39227,44973,47513.28571
9/3/2023,6,Agency_6,Sunday,41569,18289,Festival,0,153,59.86,85591,45195,40.84,57227,15494,36494,26599,34585,12466.14286,59858,72721,63093,47051.14286
9/4/2023,6,Agency_6,Monday,32859,9559,Festival,0,153,42.42,85591,45195,51.31,41569,18289,31829,19782,34732.14286,11005.71429,42418,59858,51611,45737.85714
9/5/2023,6,Agency_6,Tuesday,24189,0,Festival,1,153,24.19,85591,45195,62.34,32859,9559,24419,7005,34699.28571,10005,24189,42418,31424,44704.28571
9/6/2023,6,Agency_6,Wednesday,42784,11447,Festival,1,153,54.23,85591,45195,45.03,24189,0,38026,12823,35379,9808.428571,54231,24189,50849,45187.42857
9/7/2023,6,Agency_6,Thursday,33980,13059,Concert,1,153,47.04,85591,45195,48.3,42784,11447,19445,4223,37455.42857,11070.71429,47039,54231,23668,48526.14286
9/8/2023,6,Agency_6,Friday,29545,12333,Sports Event,0,153,41.88,85591,45195,51.03,33980,13059,29580,9647,37450.42857,11454.42857,41878,47039,39227,48904.85714
9/9/2023,6,Agency_6,Saturday,47806,10847,Sports Event,1,153,58.65,85591,45195,42.94,29545,12333,57227,15494,36104.57143,10790.57143,58653,41878,72721,46895.14286
9/10/2023,6,Agency_6,Sunday,58383,14124,Festival,1,153,72.51,85591,45195,35.35,47806,10847,41569,18289,38506.57143,10195.57143,72507,58653,59858,48702.14286
9/11/2023,6,Agency_6,Monday,44132,9627,Festival,1,153,53.76,85591,45195,45.63,58383,14124,32859,9559,40117,10205.28571,53759,72507,42418,50322.28571
9/12/2023,6,Agency_6,Tuesday,25125,8785,Concert,0,153,33.91,85591,45195,55.72,44132,9627,24189,0,40250.71429,11460.28571,33910,53759,24189,51711
9/13/2023,6,Agency_6,Wednesday,30096,10130,Concert,0,153,40.23,85591,45195,52.29,25125,8785,42784,11447,38438.14286,11272.14286,40226,33910,54231,49710.28571
9/14/2023,6,Agency_6,Thursday,27984,2255,Festival,0,153,30.24,85591,45195,58.86,30096,10130,33980,13059,37581.57143,9728.714286,30239,40226,47039,47310.28571
9/15/2023,6,Agency_6,Friday,34780,15677,Sports Event,1,153,50.46,85591,45195,46.07,27984,2255,29545,12333,38329.42857,10206.42857,50457,30239,41878,48535.85714
9/16/2023,6,Agency_6,Saturday,33323,9960,Concert,0,153,43.28,85591,45195,50.8,34780,15677,47806,10847,36260.42857,10079.71429,43283,50457,58653,46340.14286
9/17/2023,6,Agency_6,Sunday,58338,11064,Concert,1,153,69.4,85591,45195,37.52,33323,9960,58383,14124,36254,9642.571429,69402,43283,72507,45896.57143
9/18/2023,6,Agency_6,Monday,12285,4678,None,0,153,16.96,85591,45195,65.01,58338,11064,44132,9627,31704.42857,8935.571429,16963,69402,53759,40640
9/19/2023,6,Agency_6,Tuesday,34279,7299,Sports Event,1,153,41.58,85591,45195,52.18,12285,4678,25125,8785,33012.14286,8723.285714,41578,16963,33910,41735.42857
9/20/2023,6,Agency_6,Wednesday,37289,14239,Concert,1,153,51.53,85591,45195,45.82,34279,7299,30096,10130,34039.71429,9310.285714,51528,41578,40226,43350
9/21/2023,6,Agency_6,Thursday,38908,13358,Sports Event,1,153,52.27,85591,45195,45.63,37289,14239,27984,2255,35600.28571,10896.42857,52266,51528,30239,46496.71429
9/22/2023,6,Agency_6,Friday,43600,7333,Festival,0,153,50.93,85591,45195,47.5,38908,13358,34780,15677,36860.28571,9704.428571,50933,52266,50457,46564.71429
9/23/2023,6,Agency_6,Saturday,38503,8798,Sports Event,0,153,47.3,85591,45195,49.02,43600,7333,33323,9960,37600.28571,9538.428571,47301,50933,43283,47138.71429
9/24/2023,6,Agency_6,Sunday,28382,8464,Concert,0,153,36.85,85591,45195,54.32,38503,8798,58338,11064,33320.85714,9167,36846,47301,69402,42487.85714
9/25/2023,6,Agency_6,Monday,34331,13608,Concert,1,153,47.94,85591,45195,47.74,28382,8464,12285,4678,36470.28571,10442.71429,47939,36846,16963,46913
9/26/2023,6,Agency_6,Tuesday,47617,6063,Sports Event,0,153,53.68,85591,45195,46.38,34331,13608,34279,7299,38375.71429,10266.14286,53680,47939,41578,48641.85714
9/27/2023,6,Agency_6,Wednesday,34936,11597,Sports Event,1,153,46.53,85591,45195,48.85,47617,6063,37289,14239,38039.57143,9888.714286,46533,53680,51528,47928.28571
9/28/2023,6,Agency_6,Thursday,42857,13154,Festival,1,153,56.01,85591,45195,43.8,34936,11597,38908,13358,38603.71429,9859.571429,56011,46533,52266,48463.28571
9/29/2023,6,Agency_6,Friday,51519,349,Festival,1,153,51.87,85591,45195,48.43,42857,13154,43600,7333,39735,8861.857143,51868,56011,50933,48596.85714
9/30/2023,6,Agency_6,Saturday,14517,8857,Festival,0,153,23.37,85591,45195,60.97,51519,349,38503,8798,36308.42857,8870.285714,23374,51868,47301,45178.71429
10/1/2023,6,Agency_6,Sunday,45874,4128,Sports Event,0,153,50,85591,45195,48.6,14517,8857,28382,8464,38807.28571,8250.857143,50002,23374,36846,47058.14286
10/2/2023,6,Agency_6,Monday,7441,10441,Festival,0,153,17.88,85591,45195,63.4,45874,4128,34331,13608,34965.85714,7798.428571,17882,50002,47939,42764.28571
10/3/2023,6,Agency_6,Tuesday,41375,6709,Concert,1,153,48.08,85591,45195,49.05,7441,10441,47617,6063,34074.14286,7890.714286,48084,17882,53680,41964.85714
10/4/2023,6,Agency_6,Wednesday,29390,7282,Festival,1,153,36.67,85591,45195,54.64,41375,6709,34936,11597,33281.85714,7274.285714,36672,48084,46533,40556.14286
10/5/2023,6,Agency_6,Thursday,40076,8917,Sports Event,1,153,48.99,85591,45195,48.15,29390,7282,42857,13154,32884.57143,6669,48993,36672,56011,39553.57143
10/6/2023,6,Agency_6,Friday,29211,0,None,1,153,29.21,85591,45195,59.83,40076,8917,51519,349,29697.71429,6619.142857,29211,48993,51868,36316.85714
10/7/2023,6,Agency_6,Saturday,36773,8499,Festival,1,153,45.27,85591,45195,50.1,29211,0,14517,8857,32877.14286,6568,45272,29211,23374,39445.14286
10/8/2023,6,Agency_6,Sunday,33692,8669,Concert,0,153,42.36,85591,45195,51.52,36773,8499,45874,4128,31136.85714,7216.714286,42361,45272,50002,38353.57143
10/9/2023,6,Agency_6,Monday,46778,3048,Festival,1,153,49.83,85591,45195,48.91,33692,8669,7441,10441,36756.42857,6160.571429,49826,42361,17882,42917
10/10/2023,6,Agency_6,Tuesday,30340,10397,Sports Event,0,153,40.74,85591,45195,51.98,46778,3048,41375,6709,35180,6687.428571,40737,49826,48084,41867.42857
10/11/2023,6,Agency_6,Wednesday,29283,4036,None,0,153,33.32,85591,45195,56.97,30340,10397,29390,7282,35164.71429,6223.714286,33319,40737,36672,41388.42857
10/12/2023,6,Agency_6,Thursday,32433,2366,Festival,0,153,34.8,85591,45195,56.56,29283,4036,40076,8917,34072.85714,5287.857143,34799,33319,48993,39360.71429
10/13/2023,6,Agency_6,Friday,15678,15919,Festival,1,153,31.6,85591,45195,55.45,32433,2366,29211,0,32139.57143,7562,31597,34799,29211,39701.57143
10/14/2023,6,Agency_6,Saturday,46734,22762,Festival,1,153,69.5,85591,45195,35.13,15678,15919,36773,8499,33562.57143,9599.571429,69496,31597,45272,43162.14286
10/15/2023,6,Agency_6,Sunday,30728,18684,Sports Event,1,153,49.41,85591,45195,45.99,46734,22762,33692,8669,33139.14286,11030.28571,49412,69496,42361,44169.42857
10/16/2023,6,Agency_6,Monday,57220,13896,Sports Event,1,153,71.12,85591,45195,36.09,30728,18684,46778,3048,34630.85714,12580,71116,49412,49826,47210.85714
10/17/2023,6,Agency_6,Tuesday,41694,11940,Sports Event,1,153,53.64,85591,45195,45.23,57220,13896,30340,10397,36252.85714,12800.42857,53634,71116,40737,49053.28571
10/18/2023,6,Agency_6,Wednesday,18217,13108,Concert,0,153,31.33,85591,45195,56.15,41694,11940,29283,4036,34672,14096.42857,31325,53634,33319,48768.42857
10/19/2023,6,Agency_6,Thursday,16945,6008,None,0,153,22.95,85591,45195,61.75,18217,13108,32433,2366,32459.42857,14616.71429,22953,31325,34799,47076.14286
10/20/2023,6,Agency_6,Friday,23758,6285,Concert,1,153,30.04,85591,45195,58.15,16945,6008,15678,15919,33613.71429,13240.42857,30043,22953,31597,46854.14286
10/21/2023,6,Agency_6,Saturday,32610,5596,None,0,153,38.21,85591,45195,54.21,23758,6285,46734,22762,31596,10788.14286,38206,30043,69496,42384.14286
10/22/2023,6,Agency_6,Sunday,63802,14984,Concert,1,153,78.79,85591,45195,32.04,32610,5596,30728,18684,36320.85714,10259.57143,78786,38206,49412,46580.42857
10/23/2023,6,Agency_6,Monday,10790,6784,None,0,153,17.57,85591,45195,64.29,63802,14984,57220,13896,29688,9243.571429,17574,78786,71116,38931.57143
10/24/2023,6,Agency_6,Tuesday,22165,8955,None,1,153,31.12,85591,45195,57.08,10790,6784,41694,11940,26898.14286,8817.142857,31120,17574,53634,35715.28571
10/25/2023,6,Agency_6,Wednesday,20126,1913,None,0,153,22.04,85591,45195,63.03,22165,8955,18217,13108,27170.85714,7217.857143,22039,31120,31325,34388.71429
10/26/2023,6,Agency_6,Thursday,31231,15966,Sports Event,0,153,47.2,85591,45195,47.64,20126,1913,16945,6008,29211.71429,8640.428571,47197,22039,22953,37852.14286
10/27/2023,6,Agency_6,Friday,29203,6837,None,1,153,36.04,85591,45195,55.04,31231,15966,23758,6285,29989.57143,8719.285714,36040,47197,30043,38708.85714
10/28/2023,6,Agency_6,Saturday,45676,11980,Concert,0,153,57.66,85591,45195,43.21,29203,6837,32610,5596,31856.14286,9631.285714,57656,36040,38206,41487.42857
10/29/2023,6,Agency_6,Sunday,49249,8712,Sports Event,1,153,57.96,85591,45195,43.71,45676,11980,63802,14984,29777.14286,8735.285714,57961,57656,78786,38512.42857
10/30/2023,6,Agency_6,Monday,31753,12019,Concert,0,153,43.77,85591,45195,50.14,49249,8712,10790,6784,32771.85714,9483.142857,43772,57961,17574,42255
10/31/2023,6,Agency_6,Tuesday,30847,18678,Festival,1,153,49.53,85591,45195,45.93,31753,12019,22165,8955,34012.14286,10872.14286,49525,43772,31120,44884.28571
11/1/2023,6,Agency_6,Wednesday,29311,5480,Concert,0,153,34.79,85591,45195,55.94,30847,18678,20126,1913,35324.28571,11381.71429,34791,49525,22039,46706
11/2/2023,6,Agency_6,Thursday,37482,7524,Concert,0,153,45.01,85591,45195,50.42,29311,5480,31231,15966,36217.28571,10175.71429,45006,34791,47197,46393
11/3/2023,6,Agency_6,Friday,30936,6182,None,1,153,37.12,85591,45195,54.64,37482,7524,29203,6837,36464.85714,10082.14286,37118,45006,36040,46547
11/4/2023,6,Agency_6,Saturday,46098,18523,Festival,1,153,64.62,85591,45195,38.42,30936,6182,45676,11980,36525.14286,11016.85714,64621,37118,57656,47542
11/5/2023,6,Agency_6,Sunday,50202,3118,Sports Event,1,153,53.32,85591,45195,47.15,46098,18523,49249,8712,36661.28571,10217.71429,53320,64621,57961,46879
11/6/2023,6,Agency_6,Monday,21589,11658,Sports Event,0,153,33.25,85591,45195,55.48,50202,3118,31753,12019,35209.28571,10166.14286,33247,53320,43772,45375.42857
11/7/2023,6,Agency_6,Tuesday,37711,9405,Concert,1,153,47.12,85591,45195,48.99,21589,11658,30847,18678,36189.85714,8841.428571,47116,33247,49525,45031.28571
11/8/2023,6,Agency_6,Wednesday,25753,6759,Sports Event,1,153,32.51,85591,45195,56.82,37711,9405,29311,5480,35681.57143,9024.142857,32512,47116,34791,44705.71429
11/9/2023,6,Agency_6,Thursday,19287,11416,Festival,1,153,30.7,85591,45195,56.8,25753,6759,37482,7524,33082.28571,9580.142857,30703,32512,45006,42662.42857
11/10/2023,6,Agency_6,Friday,25510,5212,Concert,0,153,30.72,85591,45195,58.03,19287,11416,30936,6182,32307.14286,9441.571429,30722,30703,37118,41748.71429
11/11/2023,6,Agency_6,Saturday,46002,17719,Sports Event,1,153,63.72,85591,45195,39.03,25510,5212,46098,18523,32293.42857,9326.714286,63721,30722,64621,41620.14286
11/12/2023,6,Agency_6,Sunday,71288,6113,Festival,1,153,77.4,85591,45195,34.51,46002,17719,50202,3118,35305.71429,9754.571429,77401,63721,53320,45060.28571
11/13/2023,6,Agency_6,Monday,38694,11808,Festival,0,153,50.5,85591,45195,46.82,71288,6113,21589,11658,37749.28571,9776,50502,77401,33247,47525.28571
11/14/2023,6,Agency_6,Tuesday,24156,9190,Festival,0,153,33.35,85591,45195,55.92,38694,11808,37711,9405,35812.85714,9745.285714,33346,50502,47116,45558.14286
11/15/2023,6,Agency_6,Wednesday,17711,5371,None,0,153,23.08,85591,45195,61.82,24156,9190,25753,6759,34664,9547,23082,33346,32512,44211
11/16/2023,6,Agency_6,Thursday,53712,14782,Festival,1,153,68.49,85591,45195,37.23,17711,5371,19287,11416,39581.85714,10027.85714,68494,23082,30703,49609.71429
11/17/2023,6,Agency_6,Friday,33814,7036,Sports Event,0,153,40.85,85591,45195,52.6,53712,14782,25510,5212,40768.14286,10288.42857,40850,68494,30722,51056.57143
11/18/2023,6,Agency_6,Saturday,29434,14179,Sports Event,1,153,43.61,85591,45195,49.79,33814,7036,46002,17719,38401.28571,9782.714286,43613,40850,63721,48184
11/19/2023,6,Agency_6,Sunday,46859,4298,Festival,0,153,51.16,85591,45195,47.99,29434,14179,71288,6113,34911.42857,9523.428571,51157,43613,77401,44434.85714
11/20/2023,6,Agency_6,Monday,28711,12499,Sports Event,1,153,41.21,85591,45195,51.33,46859,4298,38694,11808,33485.28571,9622.142857,41210,51157,50502,43107.42857
11/21/2023,6,Agency_6,Tuesday,22614,5803,Concert,0,153,28.42,85591,45195,59.06,28711,12499,24156,9190,33265,9138.285714,28417,41210,33346,42403.28571
11/22/2023,6,Agency_6,Wednesday,26823,3855,Festival,0,153,30.68,85591,45195,58.32,22614,5803,17711,5371,34566.71429,8921.714286,30678,28417,23082,43488.42857
11/23/2023,6,Agency_6,Thursday,29501,15246,Sports Event,1,153,44.75,85591,45195,49.01,26823,3855,53712,14782,31108,8988,44747,30678,68494,40096
11/24/2023,6,Agency_6,Friday,20194,3066,Sports Event,0,153,23.26,85591,45195,62.19,29501,15246,33814,7036,29162.28571,8420.857143,23260,44747,40850,37583.14286
11/25/2023,6,Agency_6,Saturday,39426,19996,Concert,1,153,59.42,85591,45195,40.72,20194,3066,29434,14179,30589.71429,9251.857143,59422,23260,43613,39841.57143
11/26/2023,6,Agency_6,Sunday,34227,8994,Sports Event,0,153,43.22,85591,45195,51.02,39426,19996,46859,4298,28785.14286,9922.714286,43221,59422,51157,38707.85714
11/27/2023,6,Agency_6,Monday,30331,2563,Festival,0,153,32.9,85591,45195,57.47,34227,8994,28711,12499,29016.57143,8503.285714,32894,43221,41210,37519.85714
11/28/2023,6,Agency_6,Tuesday,33709,9802,Sports Event,0,153,43.51,85591,45195,50.72,30331,2563,22614,5803,30601.57143,9074.571429,43511,32894,28417,39676.14286
11/29/2023,6,Agency_6,Wednesday,35008,16686,Festival,1,153,51.69,85591,45195,45.25,33709,9802,26823,3855,31770.85714,10907.57143,51694,43511,30678,42678.42857
11/30/2023,6,Agency_6,Thursday,28005,17266,Festival,1,153,45.27,85591,45195,48.34,35008,16686,29501,15246,31557.14286,11196.14286,45271,51694,44747,42753.28571
12/1/2023,6,Agency_6,Friday,31158,7354,Concert,0,153,38.51,85591,45195,53.71,28005,17266,20194,3066,33123.42857,11808.71429,38512,45271,23260,44932.14286
12/2/2023,6,Agency_6,Saturday,35820,10574,Concert,0,153,46.39,85591,45195,49.12,31158,7354,39426,19996,32608.28571,10462.71429,46394,38512,59422,43071
12/3/2023,6,Agency_6,Sunday,46981,6289,Festival,0,153,53.27,85591,45195,46.54,35820,10574,34227,8994,34430.28571,10076.28571,53270,46394,43221,44506.57143
12/4/2023,6,Agency_6,Monday,31564,16831,Sports Event,1,153,48.4,85591,45195,46.87,46981,6289,30331,2563,34606.42857,12114.57143,48395,53270,32894,46721
12/5/2023,6,Agency_6,Tuesday,33192,16186,Festival,1,153,49.38,85591,45195,46.51,31564,16831,33709,9802,34532.57143,13026.57143,49378,48395,43511,47559.14286
12/6/2023,6,Agency_6,Wednesday,55569,9986,Concert,1,153,65.56,85591,45195,39.66,33192,16186,35008,16686,37469.85714,12069.42857,65555,49378,51694,49539.28571
12/7/2023,6,Agency_6,Thursday,23406,2692,None,0,153,26.1,85591,45195,60.84,55569,9986,28005,17266,36812.85714,9987.428571,26098,65555,45271,46800.28571
12/8/2023,6,Agency_6,Friday,23773,5398,None,0,153,29.17,85591,45195,58.77,23406,2692,31158,7354,35757.85714,9708,29171,26098,38512,45465.85714
12/9/2023,6,Agency_6,Saturday,40257,8194,Concert,0,153,48.45,85591,45195,48.57,23773,5398,35820,10574,36391.71429,9368,48451,29171,46394,45759.71429
12/10/2023,6,Agency_6,Sunday,27363,18582,Festival,1,153,45.95,85591,45195,47.74,40257,8194,46981,6289,33589.14286,11124.14286,45945,48451,53270,44713.28571
12/11/2023,6,Agency_6,Monday,18879,10388,Concert,1,153,29.27,85591,45195,57.72,27363,18582,31564,16831,31777,10203.71429,29267,45945,48395,41980.71429
12/12/2023,6,Agency_6,Tuesday,24705,5383,None,0,153,30.09,85591,45195,58.31,18879,10388,33192,16186,30564.57143,8660.428571,30088,29267,49378,39225
12/13/2023,6,Agency_6,Wednesday,29741,7050,None,0,153,36.79,85591,45195,54.63,24705,5383,55569,9986,26874.85714,8241,36791,30088,65555,35115.85714
12/14/2023,6,Agency_6,Thursday,21749,7075,None,1,153,28.82,85591,45195,58.6,29741,7050,23406,2692,26638.14286,8867.142857,28824,36791,26098,35505.28571
12/15/2023,6,Agency_6,Friday,38537,4367,Concert,1,153,42.91,85591,45195,52.11,21749,7075,23773,5398,28747.28571,8719.857143,42904,28824,29171,37467.14286
12/16/2023,6,Agency_6,Saturday,35797,11998,Sports Event,1,153,47.8,85591,45195,48.13,38537,4367,40257,8194,28110.14286,9263.285714,47795,42904,48451,37373.42857
12/17/2023,6,Agency_6,Sunday,22974,15760,Sports Event,1,153,38.73,85591,45195,51.91,35797,11998,27363,18582,27483.14286,8860.142857,38734,47795,45945,36343.28571
12/18/2023,6,Agency_6,Monday,28131,2811,Sports Event,0,153,30.94,85591,45195,58.4,22974,15760,18879,10388,28804.85714,7777.714286,30942,38734,29267,36582.57143
12/19/2023,6,Agency_6,Tuesday,33031,10932,Festival,0,153,43.96,85591,45195,50.26,28131,2811,24705,5383,29994.28571,8570.428571,43963,30942,30088,38564.71429
12/20/2023,6,Agency_6,Wednesday,31702,7396,Concert,0,153,39.1,85591,45195,53.4,33031,10932,29741,7050,30274.42857,8619.857143,39098,43963,36791,38894.28571
12/21/2023,6,Agency_6,Thursday,44766,15136,Festival,1,153,59.9,85591,45195,41.45,31702,7396,21749,7075,33562.57143,9771.428571,59902,39098,28824,43334
12/22/2023,6,Agency_6,Friday,27998,4690,None,1,153,32.69,85591,45195,57.15,44766,15136,38537,4367,32057,9817.571429,32688,59902,42904,41874.57143
12/23/2023,6,Agency_6,Saturday,38489,16331,Concert,0,153,54.82,85591,45195,43.75,27998,4690,35797,11998,32441.57143,10436.57143,54820,32688,47795,42878.14286
12/24/2023,6,Agency_6,Sunday,39817,28449,Festival,1,153,68.27,85591,45195,34.61,38489,16331,22974,15760,34847.71429,12249.28571,68266,54820,38734,47097
12/25/2023,6,Agency_6,Monday,17371,5064,None,0,153,22.43,85591,45195,62.2,39817,28449,28131,2811,33310.57143,12571.14286,22435,68266,30942,45881.71429
12/26/2023,6,Agency_6,Tuesday,32442,12961,Concert,1,153,45.4,85591,45195,49.14,17371,5064,33031,10932,33226.42857,12861,45403,22435,43963,46087.42857
12/27/2023,6,Agency_6,Wednesday,16932,6641,Sports Event,0,153,23.57,85591,45195,61.32,32442,12961,31702,7396,31116.42857,12753.14286,23573,45403,39098,43869.57143
12/28/2023,6,Agency_6,Thursday,14539,5270,None,0,153,19.81,85591,45195,63.47,16932,6641,44766,15136,26798.28571,11343.71429,19809,23573,59902,38142
12/29/2023,6,Agency_6,Friday,37458,10696,Sports Event,0,153,48.15,85591,45195,48.22,14539,5270,27998,4690,28149.71429,12201.71429,48154,19809,32688,40351.42857
12/30/2023,6,Agency_6,Saturday,19049,28105,Concert,1,153,47.16,85591,45195,45.23,37458,10696,38489,16331,25372.57143,13883.71429,47154,48154,54820,39256.28571
12/31/2023,6,Agency_6,Sunday,50253,10665,Sports Event,1,153,60.92,85591,45195,41.84,19049,28105,39817,28449,26863.42857,11343.14286,60918,47154,68266,38206.57143
1/8/2023,7,Agency_7,Sunday,43556,5047,Festival,0,60,48.6,71172,20394,24.55,25945,5114,32424,9740,30912.57143,8154.142857,48603,31059,42164,39066.71429
1/9/2023,7,Agency_7,Monday,23244,5220,Sports Event,0,60,28.46,71172,20394,34.59,43556,5047,32496,12840,29590.85714,7065.571429,28464,48603,45336,36656.42857
1/10/2023,7,Agency_7,Tuesday,25400,6885,None,0,60,32.29,71172,20394,32.34,23244,5220,33075,9974,28494.42857,6624.285714,32285,28464,43049,35118.71429
1/11/2023,7,Agency_7,Wednesday,33654,12143,Sports Event,0,60,45.8,71172,20394,24.53,25400,6885,16568,2134,30935.28571,8054.142857,45797,32285,18702,38989.42857
1/12/2023,7,Agency_7,Thursday,23404,9684,Festival,0,60,33.09,71172,20394,31.38,33654,12143,20729,6170,31317.42857,8556.142857,33088,45797,26899,39873.57143
1/13/2023,7,Agency_7,Friday,29061,11378,Concert,0,60,40.44,71172,20394,27.37,23404,9684,44019,15800,29180.57143,7924.428571,40439,33088,59819,37105
1/14/2023,7,Agency_7,Saturday,34961,9348,Sports Event,0,60,44.31,71172,20394,25.84,29061,11378,25945,5114,30468.57143,8529.285714,44309,40439,31059,38997.85714
1/15/2023,7,Agency_7,Sunday,40867,14921,Festival,0,60,55.79,71172,20394,18.98,34961,9348,43556,5047,30084.42857,9939.857143,55788,44309,48603,40024.28571
1/16/2023,7,Agency_7,Monday,21655,6827,None,1,60,28.48,71172,20394,34.25,40867,14921,23244,5220,29857.42857,10169.42857,28482,55788,28464,40026.85714
1/17/2023,7,Agency_7,Tuesday,22060,5,Concert,0,60,22.07,71172,20394,38.83,21655,6827,25400,6885,29380.28571,9186.571429,22065,28482,32285,38566.85714
1/18/2023,7,Agency_7,Wednesday,40953,14796,Concert,1,60,55.75,71172,20394,19.03,22060,5,33654,12143,30423,9565.571429,55749,22065,45797,39988.57143
1/19/2023,7,Agency_7,Thursday,41554,2618,Concert,1,60,44.17,71172,20394,27.25,40953,14796,23404,9684,33015.85714,8556.142857,44172,55749,33088,41572
1/20/2023,7,Agency_7,Friday,35577,1339,Festival,1,60,36.92,71172,20394,31.13,41554,2618,29061,11378,33946.71429,7122,36916,44172,40439,41068.71429
1/21/2023,7,Agency_7,Saturday,48326,6247,Concert,0,60,54.57,71172,20394,21.33,35577,1339,34961,9348,35856,6679,54573,36916,44309,42535
1/22/2023,7,Agency_7,Sunday,61488,21320,Sports Event,1,60,82.81,71172,20394,4.19,48326,6247,40867,14921,38801.85714,7593.142857,82808,54573,55788,46395
1/23/2023,7,Agency_7,Monday,30219,6506,Concert,1,60,36.73,71172,20394,30.2,61488,21320,21655,6827,40025.28571,7547.285714,36725,82808,28482,47572.57143
1/24/2023,7,Agency_7,Tuesday,28276,4635,None,1,60,32.91,71172,20394,32.48,30219,6506,22060,5,40913.28571,8208.714286,32911,36725,22065,49122
1/25/2023,7,Agency_7,Wednesday,39998,9600,Sports Event,1,60,49.6,71172,20394,23.14,28276,4635,40953,14796,40776.85714,7466.428571,49598,32911,55749,48243.28571
1/26/2023,7,Agency_7,Thursday,16641,916,Sports Event,0,60,17.56,71172,20394,40.9,39998,9600,41554,2618,37217.85714,7223.285714,17557,49598,44172,44441.14286
1/27/2023,7,Agency_7,Friday,41209,9224,Concert,1,60,50.43,71172,20394,22.8,16641,916,35577,1339,38022.42857,8349.714286,50433,17557,36916,46372.14286
1/28/2023,7,Agency_7,Saturday,40327,19773,Festival,1,60,60.1,71172,20394,15.86,41209,9224,48326,6247,36879.71429,10282,60100,50433,54573,47161.71429
1/29/2023,7,Agency_7,Sunday,46560,9843,Festival,0,60,56.4,71172,20394,19.69,40327,19773,61488,21320,34747.14286,8642.428571,56403,60100,82808,43389.57143
1/30/2023,7,Agency_7,Monday,18297,6000,None,0,60,24.3,71172,20394,36.51,46560,9843,30219,6506,33044,8570.142857,24297,56403,36725,41614.14286
1/31/2023,7,Agency_7,Tuesday,25769,12961,Sports Event,1,60,38.73,71172,20394,27.9,18297,6000,28276,4635,32685.85714,9759.571429,38730,24297,32911,42445.42857
2/1/2023,7,Agency_7,Wednesday,44380,15136,Festival,1,60,59.52,71172,20394,17.08,25769,12961,39998,9600,33311.85714,10550.42857,59516,38730,49598,43862.28571
2/2/2023,7,Agency_7,Thursday,15474,5910,Sports Event,0,60,21.38,71172,20394,37.99,44380,15136,16641,916,33145.14286,11263.85714,21384,59516,17557,44409
2/3/2023,7,Agency_7,Friday,23412,8838,Sports Event,0,60,32.25,71172,20394,31.97,15474,5910,41209,9224,30602.71429,11208.71429,32250,21384,50433,41811.42857
2/4/2023,7,Agency_7,Saturday,34948,14547,None,1,60,49.5,71172,20394,22.2,23412,8838,40327,19773,29834.28571,10462.14286,49495,32250,60100,40296.42857
2/5/2023,7,Agency_7,Sunday,41008,12388,Concert,1,60,53.4,71172,20394,20.69,34948,14547,46560,9843,29041.14286,10825.71429,53396,49495,56403,39866.85714
2/6/2023,7,Agency_7,Monday,33472,7830,None,1,60,41.3,71172,20394,27.64,41008,12388,18297,6000,31209,11087.14286,41302,53396,24297,42296.14286
2/7/2023,7,Agency_7,Tuesday,51359,13273,Concert,1,60,64.63,71172,20394,14.89,33472,7830,25769,12961,34864.71429,11131.71429,64632,41302,38730,45996.42857
2/8/2023,7,Agency_7,Wednesday,27717,5552,Concert,1,60,33.27,71172,20394,32.12,51359,13273,44380,15136,32484.28571,9762.571429,33269,64632,59516,42246.85714
2/9/2023,7,Agency_7,Thursday,23871,15051,Festival,1,60,38.92,71172,20394,27.39,27717,5552,15474,5910,33683.85714,11068.42857,38922,33269,21384,44752.28571
2/10/2023,7,Agency_7,Friday,38913,14786,Festival,0,60,53.7,71172,20394,20.05,23871,15051,23412,8838,35898.28571,11918.14286,53699,38922,32250,47816.42857
2/11/2023,7,Agency_7,Saturday,29058,9522,None,0,60,38.58,71172,20394,28.67,38913,14786,34948,14547,35056.85714,11200.28571,38580,53699,49495,46257.14286
2/12/2023,7,Agency_7,Sunday,20518,3493,None,0,60,24.01,71172,20394,37.16,29058,9522,41008,12388,32129.71429,9929.571429,24011,38580,53396,42059.28571
2/13/2023,7,Agency_7,Monday,36375,9919,Concert,0,60,46.29,71172,20394,24.73,20518,3493,33472,7830,32544.42857,10228,46294,24011,41302,42772.42857
2/14/2023,7,Agency_7,Tuesday,30805,9815,Concert,0,60,40.62,71172,20394,27.59,36375,9919,51359,13273,29608.14286,9734,40620,46294,64632,39342.14286
2/15/2023,7,Agency_7,Wednesday,32422,12863,Sports Event,0,60,45.29,71172,20394,24.65,30805,9815,27717,5552,30280.28571,10778.42857,45285,40620,33269,41058.71429
2/16/2023,7,Agency_7,Thursday,26474,6088,None,0,60,32.56,71172,20394,32.36,32422,12863,23871,15051,30652.14286,9498,32562,45285,38922,40150.14286
2/17/2023,7,Agency_7,Friday,47246,14346,Sports Event,1,60,61.59,71172,20394,16.2,26474,6088,38913,14786,31842.57143,9435.142857,61592,32562,53699,41277.71429
2/18/2023,7,Agency_7,Saturday,31849,14393,Festival,0,60,46.24,71172,20394,23.86,47246,14346,29058,9522,32241.28571,10131,46242,61592,38580,42372.28571
2/19/2023,7,Agency_7,Sunday,23448,15706,Festival,0,60,39.16,71172,20394,27.14,31849,14393,20518,3493,32659.85714,11875.71429,39154,46242,24011,44535.57143
2/20/2023,7,Agency_7,Monday,14027,5571,None,0,60,19.6,71172,20394,38.95,23448,15706,36375,9919,29467.28571,11254.57143,19598,39154,46294,40721.85714
2/21/2023,7,Agency_7,Tuesday,30759,14532,Concert,1,60,45.29,71172,20394,24.31,14027,5571,30805,9815,29460.71429,11928.42857,45291,19598,40620,41389.14286
2/22/2023,7,Agency_7,Wednesday,25779,2534,None,1,60,28.31,71172,20394,35.2,30759,14532,32422,12863,28511.71429,10452.85714,28313,45291,45285,38964.57143
2/23/2023,7,Agency_7,Thursday,28733,5381,None,1,60,34.12,71172,20394,31.73,25779,2534,26474,6088,28834.42857,10351.85714,34114,28313,32562,39186.28571
2/24/2023,7,Agency_7,Friday,47589,11904,Sports Event,1,60,59.49,71172,20394,17.73,28733,5381,47246,14346,28883.42857,10003,59493,34114,61592,38886.42857
2/25/2023,7,Agency_7,Saturday,34284,5612,None,1,60,39.9,71172,20394,28.79,47589,11904,31849,14393,29231.28571,8748.571429,39896,59493,46242,37979.85714
2/26/2023,7,Agency_7,Sunday,20463,5306,None,0,60,25.77,71172,20394,35.92,34284,5612,23448,15706,28804.85714,7262.857143,25769,39896,39154,36067.71429
2/27/2023,7,Agency_7,Monday,36424,14201,Festival,0,60,50.63,71172,20394,21.71,20463,5306,14027,5571,32004.42857,8495.714286,50625,25769,19598,40500.14286
2/28/2023,7,Agency_7,Tuesday,23961,12160,Concert,0,60,36.12,71172,20394,29.37,36424,14201,30759,14532,31033.28571,8156.857143,36121,50625,45291,39190.14286
3/1/2023,7,Agency_7,Wednesday,9151,2611,None,0,60,11.76,71172,20394,43.46,23961,12160,25779,2534,28657.85714,8167.857143,11762,36121,28313,36825.71429
3/2/2023,7,Agency_7,Thursday,22809,3899,Sports Event,0,60,26.71,71172,20394,35.73,9151,2611,28733,5381,27811.57143,7956.142857,26708,11762,34114,35767.71429
3/3/2023,7,Agency_7,Friday,18123,9902,Concert,0,60,28.03,71172,20394,33.87,22809,3899,47589,11904,23602.14286,7670.142857,28025,26708,59493,31272.28571
3/4/2023,7,Agency_7,Saturday,44293,17815,Concert,1,60,62.11,71172,20394,15.24,18123,9902,34284,5612,25032,9413.428571,62108,28025,39896,34445.42857
3/5/2023,7,Agency_7,Sunday,36585,10066,None,1,60,46.65,71172,20394,24.52,44293,17815,20463,5306,27335.14286,10093.42857,46651,62108,25769,37428.57143
3/6/2023,7,Agency_7,Monday,45411,11566,Sports Event,1,60,56.98,71172,20394,19.06,36585,10066,36424,14201,28619,9717,56977,46651,50625,38336
3/7/2023,7,Agency_7,Tuesday,14065,7115,None,0,60,21.18,71172,20394,37.85,45411,11566,23961,12160,27205.28571,8996.285714,21180,56977,36121,36201.57143
3/8/2023,7,Agency_7,Wednesday,33255,7444,Concert,1,60,40.7,71172,20394,28.02,14065,7115,9151,2611,30648.71429,9686.714286,40699,21180,11762,40335.42857
3/9/2023,7,Agency_7,Thursday,28665,5395,Festival,0,60,34.06,71172,20394,31.75,33255,7444,22809,3899,31485.28571,9900.428571,34060,40699,26708,41385.71429
3/10/2023,7,Agency_7,Friday,34928,13537,Sports Event,1,60,48.47,71172,20394,22.92,28665,5395,18123,9902,33886,10419.71429,48465,34060,28025,44305.71429
3/11/2023,7,Agency_7,Saturday,50873,9913,Festival,1,60,60.79,71172,20394,17.49,34928,13537,44293,17815,34826,9290.857143,60786,48465,62108,44116.85714
3/12/2023,7,Agency_7,Sunday,41092,22115,Festival,1,60,63.21,71172,20394,13.83,50873,9913,36585,10066,35469.85714,11012.14286,63207,60786,46651,46482
3/13/2023,7,Agency_7,Monday,43839,21777,Sports Event,1,60,65.62,71172,20394,12.7,41092,22115,45411,11566,35245.28571,12470.85714,65616,63207,56977,47716.14286
3/14/2023,7,Agency_7,Tuesday,38850,12389,Concert,0,60,51.24,71172,20394,21.76,43839,21777,14065,7115,38786,13224.28571,51239,65616,21180,52010.28571
3/15/2023,7,Agency_7,Wednesday,25467,15534,Sports Event,1,60,41,71172,20394,26.25,38850,12389,33255,7444,37673.42857,14380,41001,51239,40699,52053.42857
3/16/2023,7,Agency_7,Thursday,38481,9277,Festival,1,60,47.76,71172,20394,24.13,25467,15534,28665,5395,39075.71429,14934.57143,47758,41001,34060,54010.28571
3/17/2023,7,Agency_7,Friday,40638,16398,Sports Event,1,60,57.04,71172,20394,18.06,38481,9277,34928,13537,39891.42857,15343.28571,57036,47758,48465,55234.71429
3/18/2023,7,Agency_7,Saturday,27004,4215,None,0,60,31.22,71172,20394,33.41,40638,16398,50873,9913,36481.57143,14529.28571,31219,57036,60786,51010.85714
3/19/2023,7,Agency_7,Sunday,42681,8230,Festival,0,60,50.91,71172,20394,22.76,27004,4215,41092,22115,36708.57143,12545.71429,50911,31219,63207,49254.28571
3/20/2023,7,Agency_7,Monday,41111,10455,Concert,1,60,51.57,71172,20394,21.99,42681,8230,43839,21777,36318.85714,10928.28571,51566,50911,65616,47247.14286
3/21/2023,7,Agency_7,Tuesday,24576,9144,None,1,60,33.72,71172,20394,31.17,41111,10455,38850,12389,34279.71429,10464.71429,33720,51566,51239,44744.42857
3/22/2023,7,Agency_7,Wednesday,22198,15113,Concert,0,60,37.31,71172,20394,28.18,24576,9144,25467,15534,33812.71429,10404.57143,37311,33720,41001,44217.28571
3/23/2023,7,Agency_7,Thursday,16341,6466,Festival,0,60,22.81,71172,20394,37.16,22198,15113,38481,9277,30649.85714,10003,22807,37311,47758,40652.85714
3/24/2023,7,Agency_7,Friday,32776,10485,Festival,0,60,43.26,71172,20394,26.13,16341,6466,40638,16398,29526.71429,9158.285714,43261,22807,57036,38685
3/25/2023,7,Agency_7,Saturday,23396,6350,None,0,60,29.75,71172,20394,33.72,32776,10485,27004,4215,29011.28571,9463.285714,29746,43261,31219,38474.57143
3/26/2023,7,Agency_7,Sunday,51601,14037,Sports Event,1,60,65.64,71172,20394,14.23,23396,6350,42681,8230,30285.57143,10292.85714,65638,29746,50911,40578.42857
3/27/2023,7,Agency_7,Monday,40447,11352,Concert,0,60,51.8,71172,20394,21.69,51601,14037,41111,10455,30190.71429,10421,51799,65638,51566,40611.71429
3/28/2023,7,Agency_7,Tuesday,47509,7299,Festival,1,60,54.81,71172,20394,21,40447,11352,24576,9144,33466.85714,10157.42857,54808,51799,33720,43624.28571
3/29/2023,7,Agency_7,Wednesday,29404,7478,Concert,0,60,36.88,71172,20394,29.92,47509,7299,22198,15113,34496.28571,9066.714286,36882,54808,37311,43563
3/30/2023,7,Agency_7,Thursday,29193,13613,Festival,1,60,42.81,71172,20394,25.74,29404,7478,16341,6466,36332.28571,10087.71429,42806,36882,22807,46420
3/31/2023,7,Agency_7,Friday,22504,8834,None,1,60,31.34,71172,20394,32.43,29193,13613,32776,10485,34864.85714,9851.857143,31338,42806,43261,44716.71429
4/1/2023,7,Agency_7,Saturday,26368,18647,Concert,0,60,45.02,71172,20394,23.62,22504,8834,23396,6350,35289.42857,11608.57143,45015,31338,29746,46898
4/2/2023,7,Agency_7,Sunday,36312,16825,Festival,1,60,53.14,71172,20394,19.93,26368,18647,51601,14037,33105.28571,12006.85714,53137,45015,65638,45112.14286
4/3/2023,7,Agency_7,Monday,46720,9182,Concert,1,60,55.9,71172,20394,20.07,36312,16825,40447,11352,34001.42857,11696.85714,55902,53137,51799,45698.28571
4/4/2023,7,Agency_7,Tuesday,31540,3557,None,1,60,35.1,71172,20394,31.6,46720,9182,47509,7299,31720.14286,11162.28571,35097,55902,54808,42882.42857
4/5/2023,7,Agency_7,Wednesday,35438,7039,None,1,60,42.48,71172,20394,27.22,31540,3557,29404,7478,32582.14286,11099.57143,42477,35097,36882,43681.71429
4/6/2023,7,Agency_7,Thursday,17017,4401,None,0,60,21.42,71172,20394,38.27,35438,7039,29193,13613,30842.71429,9783.571429,21418,42477,42806,40626.28571
4/7/2023,7,Agency_7,Friday,46885,9117,Festival,1,60,56,71172,20394,20.04,17017,4401,22504,8834,34325.71429,9824,56002,21418,31338,44149.71429
4/8/2023,7,Agency_7,Saturday,38032,14096,Sports Event,1,60,52.13,71172,20394,20.98,46885,9117,26368,18647,35992,9173.857143,52128,56002,45015,45165.85714
4/9/2023,7,Agency_7,Sunday,16938,11233,None,0,60,28.17,71172,20394,33.53,38032,14096,36312,16825,33224.28571,8375,28171,52128,53137,41599.28571
4/10/2023,7,Agency_7,Monday,22318,9328,None,1,60,31.65,71172,20394,32.17,16938,11233,46720,9182,29738.28571,8395.857143,31646,28171,55902,38134.14286
4/11/2023,7,Agency_7,Tuesday,27361,4242,None,1,60,31.6,71172,20394,33.21,22318,9328,31540,3557,29141.28571,8493.714286,31603,31646,35097,37635
4/12/2023,7,Agency_7,Wednesday,25961,9195,None,1,60,35.16,71172,20394,30.44,27361,4242,35438,7039,27787.42857,8801.714286,35156,31603,42477,36589.14286
4/13/2023,7,Agency_7,Thursday,37163,17578,Concert,1,60,54.74,71172,20394,18.98,25961,9195,17017,4401,30665.42857,10684.14286,54741,35156,21418,41349.57143
4/14/2023,7,Agency_7,Friday,37660,11622,Concert,0,60,49.28,71172,20394,22.9,37163,17578,46885,9117,29347.57143,11042,49282,54741,56002,40389.57143
4/15/2023,7,Agency_7,Saturday,27613,5168,None,1,60,32.78,71172,20394,32.44,37660,11622,38032,14096,27859.14286,9766.571429,32781,49282,52128,37625.71429
4/16/2023,7,Agency_7,Sunday,30477,11916,Sports Event,0,60,42.39,71172,20394,26.28,27613,5168,16938,11233,29793.28571,9864.142857,42393,32781,28171,39657.42857
4/17/2023,7,Agency_7,Monday,44319,1561,Concert,1,60,45.88,71172,20394,26.61,30477,11916,22318,9328,32936.28571,8754.571429,45880,42393,31646,41690.85714
4/18/2023,7,Agency_7,Tuesday,38920,12652,Festival,1,60,51.57,71172,20394,21.55,44319,1561,27361,4242,34587.57143,9956,51572,45880,31603,44543.57143
4/19/2023,7,Agency_7,Wednesday,27918,12889,Concert,0,60,40.81,71172,20394,26.88,38920,12652,25961,9195,34867.14286,10483.71429,40807,51572,35156,45350.85714
4/20/2023,7,Agency_7,Thursday,33162,12954,Festival,0,60,46.12,71172,20394,24.21,27918,12889,37163,17578,34295.57143,9823.142857,46116,40807,54741,44118.71429
4/21/2023,7,Agency_7,Friday,28380,11685,Sports Event,0,60,40.07,71172,20394,27.49,33162,12954,37660,11622,32969.85714,9832.142857,40065,46116,49282,42802
4/22/2023,7,Agency_7,Saturday,65929,23585,Sports Event,1,60,89.52,71172,20394,0.39,28380,11685,27613,5168,38443.57143,12463.14286,89514,40065,32781,50906.71429
4/23/2023,7,Agency_7,Sunday,22680,8175,None,1,60,30.86,71172,20394,32.8,65929,23585,30477,11916,37329.71429,11928.71429,30855,89514,42393,49258.42857
4/24/2023,7,Agency_7,Monday,27411,10162,Sports Event,0,60,37.57,71172,20394,29.04,22680,8175,44319,1561,34914.28571,13157.42857,37573,30855,45880,48071.71429
4/25/2023,7,Agency_7,Tuesday,45690,7906,Concert,1,60,53.6,71172,20394,21.48,27411,10162,38920,12652,35881.42857,12479.42857,53596,37573,51572,48360.85714
4/26/2023,7,Agency_7,Wednesday,39661,2284,Concert,1,60,41.95,71172,20394,28.43,45690,7906,27918,12889,37559,10964.42857,41945,53596,40807,48523.42857
4/27/2023,7,Agency_7,Thursday,40813,6757,Sports Event,0,60,47.57,71172,20394,24.72,39661,2284,33162,12954,38652,10079.14286,47570,41945,46116,48731.14286
4/28/2023,7,Agency_7,Friday,30418,7446,Concert,0,60,37.86,71172,20394,29.44,40813,6757,28380,11685,38943.14286,9473.571429,37864,47570,40065,48416.71429
4/29/2023,7,Agency_7,Saturday,40138,0,None,1,60,40.14,71172,20394,29.79,30418,7446,65929,23585,35258.71429,6104.285714,40138,37864,89514,41363
4/30/2023,7,Agency_7,Sunday,46603,14814,Sports Event,1,60,61.42,71172,20394,16.19,40138,0,22680,8175,38676.28571,7052.714286,61417,40138,30855,45729
5/1/2023,7,Agency_7,Monday,17731,8452,None,0,60,26.18,71172,20394,35.08,46603,14814,27411,10162,37293.42857,6808.428571,26183,61417,37573,44101.85714
5/2/2023,7,Agency_7,Tuesday,30347,15572,Sports Event,1,60,45.92,71172,20394,23.79,17731,8452,45690,7906,35101.57143,7903.571429,45919,26183,53596,43005.14286
5/3/2023,7,Agency_7,Wednesday,42472,17904,Festival,1,60,60.38,71172,20394,16.09,30347,15572,39661,2284,35503.14286,10135,60376,45919,41945,45638.14286
5/4/2023,7,Agency_7,Thursday,32494,8410,Concert,1,60,40.91,71172,20394,27.73,42472,17904,40813,6757,34314.71429,10371.14286,40904,60376,47570,44685.85714
5/5/2023,7,Agency_7,Friday,38220,9945,Festival,0,60,48.16,71172,20394,23.79,32494,8410,30418,7446,35429.28571,10728.14286,48165,40904,37864,46157.42857
5/6/2023,7,Agency_7,Saturday,22095,8665,Festival,0,60,30.76,71172,20394,32.75,38220,9945,40138,0,32851.71429,11966,30760,48165,40138,44817.71429
5/7/2023,7,Agency_7,Sunday,51318,20652,Festival,1,60,71.97,71172,20394,9.75,22095,8665,46603,14814,33525.28571,12800,71970,30760,61417,46325.28571
5/8/2023,7,Agency_7,Monday,32375,0,Concert,1,60,32.38,71172,20394,33.67,51318,20652,17731,8452,35617.28571,11592.57143,32375,71970,26183,47209.85714
5/9/2023,7,Agency_7,Tuesday,22616,2559,None,0,60,25.18,71172,20394,36.76,32375,0,30347,15572,34512.85714,9733.571429,25175,32375,45919,44246.42857
5/10/2023,7,Agency_7,Wednesday,19330,0,Concert,1,60,19.33,71172,20394,40.2,22616,2559,42472,17904,31206.85714,7175.857143,19330,25175,60376,38382.71429
5/11/2023,7,Agency_7,Thursday,36103,8936,Concert,0,60,45.04,71172,20394,25.55,19330,0,32494,8410,31722.42857,7251,45039,19330,40904,38973.42857
5/12/2023,7,Agency_7,Friday,18871,7778,None,0,60,26.65,71172,20394,34.98,36103,8936,38220,9945,28958.28571,6941.428571,26649,45039,48165,35899.71429
5/13/2023,7,Agency_7,Saturday,41734,18192,Concert,0,60,59.93,71172,20394,16.26,18871,7778,22095,8665,31763.85714,8302.428571,59926,26649,30760,40066.28571
5/14/2023,7,Agency_7,Sunday,23464,10895,Festival,0,60,34.36,71172,20394,30.5,41734,18192,51318,20652,27784.71429,6908.571429,34359,59926,71970,34693.28571
5/15/2023,7,Agency_7,Monday,17874,7719,Festival,0,60,25.59,71172,20394,35.52,23464,10895,32375,0,25713.14286,8011.285714,25593,34359,32375,33724.42857
5/16/2023,7,Agency_7,Tuesday,36574,14882,Festival,1,60,51.46,71172,20394,21.16,17874,7719,22616,2559,27707.14286,9771.714286,51456,25593,25175,37478.85714
5/17/2023,7,Agency_7,Wednesday,30340,10618,Sports Event,0,60,40.96,71172,20394,27.26,36574,14882,19330,0,29280,11288.57143,40958,51456,19330,40568.57143
5/18/2023,7,Agency_7,Thursday,35275,15825,Festival,0,60,51.1,71172,20394,21.15,30340,10618,36103,8936,29161.71429,12272.71429,51100,40958,45039,41434.42857
5/19/2023,7,Agency_7,Friday,27634,5298,Concert,0,60,32.93,71172,20394,32.34,35275,15825,18871,7778,30413.57143,11918.42857,32932,51100,26649,42332
5/20/2023,7,Agency_7,Saturday,49678,10504,Festival,1,60,60.18,71172,20394,17.67,27634,5298,41734,18192,31548.42857,10820.14286,60182,32932,59926,42368.57143
5/21/2023,7,Agency_7,Sunday,49336,9796,Concert,0,60,59.13,71172,20394,18.34,49678,10504,23464,10895,35244.42857,10663.14286,59132,60182,34359,45907.57143
5/22/2023,7,Agency_7,Monday,25758,6896,Sports Event,0,60,32.65,71172,20394,32.15,49336,9796,17874,7719,36370.71429,10545.57143,32654,59132,25593,46916.28571
5/23/2023,7,Agency_7,Tuesday,35388,7962,Festival,0,60,43.35,71172,20394,26.59,25758,6896,36574,14882,36201.28571,9557,43350,32654,51456,45758.28571
5/24/2023,7,Agency_7,Wednesday,21828,11662,None,1,60,33.49,71172,20394,30.78,35388,7962,30340,10618,34985.28571,9706.142857,33490,43350,40958,44691.42857
5/25/2023,7,Agency_7,Thursday,30652,12068,Concert,1,60,42.72,71172,20394,26.09,21828,11662,35275,15825,34324.85714,9169.428571,42720,33490,51100,43494.28571
5/26/2023,7,Agency_7,Friday,30239,2431,None,1,60,32.67,71172,20394,33.04,30652,12068,27634,5298,34697,8759.857143,32670,42720,32932,43456.85714
5/27/2023,7,Agency_7,Saturday,26881,3755,None,0,60,30.64,71172,20394,33.79,30239,2431,49678,10504,31440.28571,7795.714286,30636,32670,60182,39236
5/28/2023,7,Agency_7,Sunday,56424,9510,Sports Event,1,60,65.94,71172,20394,14.99,26881,3755,49336,9796,32452.85714,7754.857143,65934,30636,59132,40207.71429
5/29/2023,7,Agency_7,Monday,35194,12258,Festival,0,60,47.45,71172,20394,23.68,56424,9510,25758,6896,33800.85714,8520.857143,47452,65934,32654,42321.71429
5/30/2023,7,Agency_7,Tuesday,31599,7702,None,1,60,39.3,71172,20394,28.67,35194,12258,35388,7962,33259.57143,8483.714286,39301,47452,43350,41743.28571
5/31/2023,7,Agency_7,Wednesday,28264,6539,Sports Event,0,60,34.8,71172,20394,31.15,31599,7702,21828,11662,34179,7751.857143,34803,39301,33490,41930.85714
6/1/2023,7,Agency_7,Thursday,41032,6121,Sports Event,0,60,47.15,71172,20394,25.06,28264,6539,30652,12068,35661.85714,6902.285714,47153,34803,42720,42564.14286
6/2/2023,7,Agency_7,Friday,28887,15065,Festival,1,60,43.95,71172,20394,24.87,41032,6121,30239,2431,35468.71429,8707.142857,43952,47153,32670,44175.85714
6/3/2023,7,Agency_7,Saturday,19222,4028,None,0,60,23.25,71172,20394,37.43,28887,15065,26881,3755,34374.57143,8746.142857,23250,43952,30636,43120.71429
6/4/2023,7,Agency_7,Sunday,29907,12481,Concert,1,60,42.39,71172,20394,26.17,19222,4028,56424,9510,30586.42857,9170.571429,42388,23250,65934,39757
6/5/2023,7,Agency_7,Monday,19586,5486,None,0,60,25.07,71172,20394,36.23,29907,12481,35194,12258,28356.71429,8203.142857,25072,42388,47452,36559.85714
6/6/2023,7,Agency_7,Tuesday,48274,14406,Concert,1,60,62.68,71172,20394,15.64,19586,5486,31599,7702,30738.85714,9160.857143,62680,25072,39301,39899.71429
6/7/2023,7,Agency_7,Wednesday,37137,10955,Festival,1,60,48.09,71172,20394,23.62,48274,14406,28264,6539,32006.42857,9791.714286,48092,62680,34803,41798.14286
6/8/2023,7,Agency_7,Thursday,33825,12826,Sports Event,0,60,46.65,71172,20394,23.97,37137,10955,41032,6121,30976.85714,10749.57143,46651,48092,47153,41726.42857
6/9/2023,7,Agency_7,Friday,26820,5685,None,1,60,32.51,71172,20394,32.47,33825,12826,28887,15065,30681.57143,9409.571429,32505,46651,43952,40091.14286
6/10/2023,7,Agency_7,Saturday,35181,6525,Festival,1,60,41.71,71172,20394,27.7,26820,5685,19222,4028,32961.42857,9766.285714,41706,32505,23250,42727.71429
6/11/2023,7,Agency_7,Sunday,41995,13602,Festival,0,60,55.6,71172,20394,19.34,35181,6525,29907,12481,34688.28571,9926.428571,55597,41706,42388,44614.71429
6/12/2023,7,Agency_7,Monday,34329,8061,Festival,0,60,42.39,71172,20394,27.05,41995,13602,19586,5486,36794.42857,10294.28571,42390,55597,25072,47088.71429
6/13/2023,7,Agency_7,Tuesday,52716,9593,Festival,1,60,62.31,71172,20394,16.79,34329,8061,48274,14406,37429,9606.714286,62309,42390,62680,47035.71429
6/14/2023,7,Agency_7,Wednesday,32208,6890,None,1,60,39.1,71172,20394,28.93,52716,9593,37137,10955,36724.85714,9026,39098,62309,48092,45750.85714
6/15/2023,7,Agency_7,Thursday,25437,10514,Concert,0,60,35.95,71172,20394,29.78,32208,6890,33825,12826,35526.57143,8695.714286,35951,39098,46651,44222.28571
6/16/2023,7,Agency_7,Friday,42993,13596,Festival,1,60,56.59,71172,20394,18.85,25437,10514,26820,5685,37837,9825.857143,56589,35951,32505,47662.85714
6/17/2023,7,Agency_7,Saturday,36730,10882,Concert,0,60,47.61,71172,20394,23.88,42993,13596,35181,6525,38058.28571,10448.28571,47612,56589,41706,48506.57143
6/18/2023,7,Agency_7,Sunday,57493,16283,Sports Event,0,60,73.78,71172,20394,9.72,36730,10882,41995,13602,40272.28571,10831.28571,73776,47612,55597,51103.57143
6/19/2023,7,Agency_7,Monday,35421,8879,Sports Event,0,60,44.3,71172,20394,25.94,57493,16283,34329,8061,40428.28571,10948.14286,44300,73776,42390,51376.42857
6/20/2023,7,Agency_7,Tuesday,48818,14363,Concert,1,60,63.18,71172,20394,15.4,35421,8879,52716,9593,39871.42857,11629.57143,63181,44300,62309,51501
6/21/2023,7,Agency_7,Wednesday,39255,10452,Festival,1,60,49.71,71172,20394,22.92,48818,14363,32208,6890,40878.14286,12138.42857,49707,63181,39098,53016.57143
6/22/2023,7,Agency_7,Thursday,29392,0,Sports Event,0,60,29.39,71172,20394,35.17,39255,10452,25437,10514,41443.14286,10636.42857,29392,49707,35951,52079.57143
6/23/2023,7,Agency_7,Friday,31579,6839,Concert,0,60,38.42,71172,20394,29.28,29392,0,42993,13596,39812.57143,9671.142857,38418,29392,56589,49483.71429
6/24/2023,7,Agency_7,Saturday,50333,11133,Concert,0,60,61.47,71172,20394,16.9,31579,6839,36730,10882,41755.85714,9707,61466,38418,47612,51462.85714
6/25/2023,7,Agency_7,Sunday,25299,10829,Festival,0,60,36.13,71172,20394,29.63,50333,11133,57493,16283,37156.71429,8927.857143,36128,61466,73776,46084.57143
6/26/2023,7,Agency_7,Monday,22153,10108,Sports Event,0,60,32.26,71172,20394,31.71,25299,10829,35421,8879,35261.28571,9103.428571,32261,36128,44300,44364.71429
6/27/2023,7,Agency_7,Tuesday,41835,16457,Concert,1,60,58.29,71172,20394,17.42,22153,10108,48818,14363,34263.71429,9402.571429,58292,32261,63181,43666.28571
6/28/2023,7,Agency_7,Wednesday,16045,5068,None,0,60,21.11,71172,20394,38.29,41835,16457,39255,10452,30948,8633.428571,21113,58292,49707,39581.42857
6/29/2023,7,Agency_7,Thursday,25689,15236,Concert,1,60,40.93,71172,20394,26.35,16045,5068,29392,0,30419,10810,40925,21113,29392,41229
6/30/2023,7,Agency_7,Friday,33891,10184,Concert,0,60,44.08,71172,20394,25.79,25689,15236,31579,6839,30749.28571,11287.85714,44075,40925,38418,42037.14286
7/1/2023,7,Agency_7,Saturday,46818,18034,Festival,1,60,64.85,71172,20394,13.83,33891,10184,50333,11133,30247.14286,12273.71429,64852,44075,61466,42520.85714
7/2/2023,7,Agency_7,Sunday,65569,13703,Sports Event,1,60,79.27,71172,20394,7.48,46818,18034,25299,10829,36000,12684.28571,79272,64852,36128,48684.28571
7/3/2023,7,Agency_7,Monday,40351,6728,Sports Event,1,60,47.08,71172,20394,24.98,65569,13703,22153,10108,38599.71429,12201.42857,47079,79272,32261,50801.14286
7/4/2023,7,Agency_7,Tuesday,23487,8831,Concert,0,60,32.32,71172,20394,31.94,40351,6728,41835,16457,35978.57143,11112,32318,47079,58292,47090.57143
7/5/2023,7,Agency_7,Wednesday,25519,4487,None,0,60,30.01,71172,20394,33.96,23487,8831,16045,5068,37332,11029,30006,32318,21113,48361
7/6/2023,7,Agency_7,Thursday,28230,7116,Concert,0,60,35.35,71172,20394,30.77,25519,4487,25689,15236,37695,9869,35346,30006,40925,47564
7/7/2023,7,Agency_7,Friday,25989,9501,Festival,0,60,35.49,71172,20394,30.22,28230,7116,33891,10184,36566.14286,9771.428571,35490,35346,44075,46337.57143
7/8/2023,7,Agency_7,Saturday,22523,16709,Concert,0,60,39.23,71172,20394,26.9,25989,9501,46818,18034,33095.42857,9582.142857,39232,35490,64852,42677.57143
7/9/2023,7,Agency_7,Sunday,26008,11726,None,1,60,37.73,71172,20394,28.65,22523,16709,65569,13703,27443.85714,9299.714286,37734,39232,79272,36743.57143
7/10/2023,7,Agency_7,Monday,17745,8871,None,1,60,26.62,71172,20394,34.78,26008,11726,40351,6728,24214.42857,9605.857143,26616,37734,47079,33820.28571
7/11/2023,7,Agency_7,Tuesday,45550,13727,Concert,1,60,59.28,71172,20394,17.48,17745,8871,23487,8831,27366.28571,10305.28571,59277,26616,32318,37671.57143
7/12/2023,7,Agency_7,Wednesday,22540,9348,Festival,0,60,31.89,71172,20394,32.05,45550,13727,25519,4487,26940.71429,10999.71429,31888,59277,30006,37940.42857
7/13/2023,7,Agency_7,Thursday,27463,10695,Sports Event,1,60,38.16,71172,20394,28.64,22540,9348,28230,7116,26831.14286,11511,38158,31888,35346,38342.14286
7/14/2023,7,Agency_7,Friday,37720,11208,Sports Event,0,60,48.93,71172,20394,23.16,27463,10695,25989,9501,28507,11754.85714,48928,38158,35490,40261.85714
7/15/2023,7,Agency_7,Saturday,36135,6740,Concert,0,60,42.88,71172,20394,27.08,37720,11208,22523,16709,30451.57143,10330.71429,42875,48928,39232,40782.28571
7/16/2023,7,Agency_7,Sunday,41808,11133,Concert,0,60,52.94,71172,20394,21.16,36135,6740,26008,11726,32708.71429,10246,52941,42875,37734,42954.71429
7/17/2023,7,Agency_7,Monday,12597,11160,Sports Event,0,60,23.76,71172,20394,35.75,41808,11133,17745,8871,31973.28571,10573,23757,52941,26616,42546.28571
7/18/2023,7,Agency_7,Tuesday,38762,17621,Festival,1,60,56.38,71172,20394,18.15,12597,11160,45550,13727,31003.57143,11129.28571,56383,23757,59277,42132.85714
7/19/2023,7,Agency_7,Wednesday,21784,0,Concert,0,60,21.78,71172,20394,38.97,38762,17621,22540,9348,30895.57143,9793.857143,21784,56383,31888,40689.42857
7/20/2023,7,Agency_7,Thursday,32092,9491,Concert,0,60,41.58,71172,20394,27.17,21784,0,27463,10695,31556.85714,9621.857143,41583,21784,38158,41178.71429
7/21/2023,7,Agency_7,Friday,22514,7242,Concert,1,60,29.76,71172,20394,33.53,32092,9491,37720,11208,29384.57143,9055.285714,29756,41583,48928,38439.85714
7/22/2023,7,Agency_7,Saturday,79035,13576,Sports Event,1,60,92.61,71172,20394,0.84,22514,7242,36135,6740,35513.14286,10031.85714,92611,29756,42875,45545
7/23/2023,7,Agency_7,Sunday,42577,8172,Sports Event,0,60,50.75,71172,20394,22.85,79035,13576,41808,11133,35623,9608.857143,50749,92611,52941,45231.85714
7/24/2023,7,Agency_7,Monday,18618,11088,Sports Event,1,60,29.71,71172,20394,32.79,42577,8172,12597,11160,36483.14286,9598.571429,29706,50749,23757,46081.71429
7/25/2023,7,Agency_7,Tuesday,24272,5880,None,1,60,30.15,71172,20394,33.61,18618,11088,38762,17621,34413.14286,7921.285714,30152,29706,56383,42334.42857
7/26/2023,7,Agency_7,Wednesday,37880,13156,Festival,1,60,51.04,71172,20394,21.71,24272,5880,21784,0,36712.57143,9800.714286,51036,30152,21784,46513.28571
7/27/2023,7,Agency_7,Thursday,19249,2471,None,0,60,21.72,71172,20394,38.51,37880,13156,32092,9491,34877.85714,8797.857143,21720,51036,41583,43675.71429
7/28/2023,7,Agency_7,Friday,43738,2620,Sports Event,1,60,46.36,71172,20394,26.16,19249,2471,22514,7242,37909.85714,8137.571429,46358,21720,29756,46047.42857
7/29/2023,7,Agency_7,Saturday,11697,8421,None,0,60,20.12,71172,20394,38.12,43738,2620,79035,13576,28290.14286,7401.142857,20118,46358,92611,35691.28571
7/30/2023,7,Agency_7,Sunday,40563,10795,Sports Event,0,60,51.36,71172,20394,22.02,11697,8421,42577,8172,28002.42857,7775.857143,51358,20118,50749,35778.28571
7/31/2023,7,Agency_7,Monday,19533,6092,Sports Event,0,60,25.63,71172,20394,35.83,40563,10795,18618,11088,28133.14286,7062.142857,25625,51358,29706,35195.28571
8/1/2023,7,Agency_7,Tuesday,36437,4303,Concert,1,60,40.74,71172,20394,28.63,19533,6092,24272,5880,29871,6836.857143,40740,25625,30152,36707.85714
8/2/2023,7,Agency_7,Wednesday,31792,15003,Sports Event,1,60,46.8,71172,20394,23.46,36437,4303,37880,13156,29001.28571,7100.714286,46795,40740,51036,36102
8/3/2023,7,Agency_7,Thursday,52915,9903,Festival,1,60,62.82,71172,20394,16.47,31792,15003,19249,2471,33810.71429,8162.428571,62818,46795,21720,41973.14286
8/4/2023,7,Agency_7,Friday,35673,1990,Sports Event,0,60,37.66,71172,20394,30.63,52915,9903,43738,2620,32658.57143,8072.428571,37663,62818,46358,40731
8/5/2023,7,Agency_7,Saturday,54514,10494,Sports Event,1,60,65.01,71172,20394,15.26,35673,1990,11697,8421,38775.28571,8368.571429,65008,37663,20118,47143.85714
8/6/2023,7,Agency_7,Sunday,25843,5855,None,0,60,31.7,71172,20394,32.84,54514,10494,40563,10795,36672.42857,7662.857143,31698,65008,51358,44335.28571
8/7/2023,7,Agency_7,Monday,51873,7737,Sports Event,1,60,59.61,71172,20394,18.51,25843,5855,19533,6092,41292.42857,7897.857143,59610,31698,25625,49190.28571
8/8/2023,7,Agency_7,Tuesday,23138,4440,None,0,60,27.58,71172,20394,35.18,51873,7737,36437,4303,39392.57143,7917.428571,27578,59610,40740,47310
8/9/2023,7,Agency_7,Wednesday,28812,7874,Concert,0,60,36.69,71172,20394,29.94,23138,4440,31792,15003,38966.85714,6899,36686,27578,46795,45865.85714
8/10/2023,7,Agency_7,Thursday,30753,11830,Sports Event,1,60,42.58,71172,20394,26.2,28812,7874,52915,9903,35800.85714,7174.285714,42583,36686,62818,42975.14286
8/11/2023,7,Agency_7,Friday,38387,13047,Festival,1,60,51.43,71172,20394,21.53,30753,11830,35673,1990,36188.57143,8753.857143,51434,42583,37663,44942.42857
8/12/2023,7,Agency_7,Saturday,24506,8573,None,0,60,33.08,71172,20394,31.61,38387,13047,54514,10494,31901.71429,8479.428571,33079,51434,65008,40381.14286
8/13/2023,7,Agency_7,Sunday,44310,6404,Sports Event,0,60,50.72,71172,20394,23.22,24506,8573,25843,5855,34539.85714,8557.857143,50714,33079,31698,43097.71429
8/14/2023,7,Agency_7,Monday,36514,4465,Sports Event,0,60,40.98,71172,20394,28.48,44310,6404,51873,7737,32345.71429,8090.428571,40979,50714,59610,40436.14286
8/15/2023,7,Agency_7,Tuesday,44731,14848,Festival,1,60,59.58,71172,20394,17.1,36514,4465,23138,4440,35430.42857,9577.285714,59579,40979,27578,45007.71429
8/16/2023,7,Agency_7,Wednesday,15664,8814,Concert,0,60,24.48,71172,20394,35.86,44731,14848,28812,7874,33552.14286,9711.571429,24478,59579,36686,43263.71429
8/17/2023,7,Agency_7,Thursday,17657,3482,None,0,60,21.14,71172,20394,38.6,15664,8814,30753,11830,31681.28571,8519,21139,24478,42583,40200.28571
8/18/2023,7,Agency_7,Friday,52170,8786,Sports Event,1,60,60.96,71172,20394,17.63,17657,3482,38387,13047,33650.28571,7910.285714,60956,21139,51434,41560.57143
8/19/2023,7,Agency_7,Saturday,24910,9374,None,1,60,34.28,71172,20394,30.84,52170,8786,24506,8573,33708,8024.714286,34284,60956,33079,41732.71429
8/20/2023,7,Agency_7,Sunday,54819,14591,Concert,1,60,69.41,71172,20394,12.24,24910,9374,44310,6404,35209.28571,9194.285714,69410,34284,50714,44403.57143
8/21/2023,7,Agency_7,Monday,38746,10303,Sports Event,0,60,49.05,71172,20394,23.28,54819,14591,36514,4465,35528.14286,10028.28571,49049,69410,40979,45556.42857
8/22/2023,7,Agency_7,Tuesday,17760,9379,Concert,1,60,27.14,71172,20394,34.42,38746,10303,44731,14848,31675.14286,9247,27139,49049,59579,40922.14286
8/23/2023,7,Agency_7,Wednesday,25785,10128,Concert,0,60,35.91,71172,20394,29.88,17760,9379,15664,8814,33121,9434.714286,35913,27139,24478,42555.71429
8/24/2023,7,Agency_7,Thursday,10312,17166,Concert,0,60,27.48,71172,20394,32.69,25785,10128,17657,3482,32071.71429,11389.57143,27478,35913,21139,43461.28571
8/25/2023,7,Agency_7,Friday,29451,7415,None,1,60,36.87,71172,20394,29.94,10312,17166,52170,8786,28826.14286,11193.71429,36866,27478,60956,40019.85714
8/26/2023,7,Agency_7,Saturday,60622,29971,Festival,1,60,90.59,71172,20394,-1.43,29451,7415,24910,9374,33927.85714,14136.14286,90593,36866,34284,48064
8/27/2023,7,Agency_7,Sunday,56986,21339,Sports Event,1,60,78.33,71172,20394,6.43,60622,29971,54819,14591,34237.42857,15100.14286,78325,90593,69410,49337.57143
8/28/2023,7,Agency_7,Monday,30979,8017,Concert,0,60,39,71172,20394,28.76,56986,21339,38746,10303,33127.85714,14773.57143,38996,78325,49049,47901.42857
8/29/2023,7,Agency_7,Tuesday,26431,5689,Concert,0,60,32.12,71172,20394,32.66,30979,8017,17760,9379,34366.57143,14246.42857,32120,38996,27139,48613
8/30/2023,7,Agency_7,Wednesday,21533,3217,None,1,60,24.75,71172,20394,36.84,26431,5689,25785,10128,33759.14286,13259.14286,24750,32120,35913,47018.28571
8/31/2023,7,Agency_7,Thursday,25506,2282,None,1,60,27.79,71172,20394,35.51,21533,3217,10312,17166,35929.71429,11132.85714,27788,24750,27478,47062.57143
9/1/2023,7,Agency_7,Friday,40860,11726,Sports Event,1,60,52.59,71172,20394,21.22,25506,2282,29451,7415,37559.57143,11748.71429,52586,27788,36866,49308.28571
9/2/2023,7,Agency_7,Saturday,32345,7198,None,1,60,39.54,71172,20394,28.65,40860,11726,60622,29971,33520,8495.428571,39543,52586,90593,42015.42857
9/3/2023,7,Agency_7,Sunday,63691,17061,Concert,0,60,80.75,71172,20394,6.07,32345,7198,56986,21339,34477.85714,7884.285714,80752,39543,78325,42362.14286
9/4/2023,7,Agency_7,Monday,26865,13006,Sports Event,1,60,39.87,71172,20394,27.32,63691,17061,30979,8017,33890.14286,8597,39871,80752,38996,42487.14286
9/5/2023,7,Agency_7,Tuesday,33070,7070,Sports Event,1,60,40.14,71172,20394,28.38,26865,13006,26431,5689,34838.57143,8794.285714,40140,39871,32120,43632.85714
9/6/2023,7,Agency_7,Wednesday,13299,5864,None,0,60,19.16,71172,20394,39.11,33070,7070,21533,3217,33662.28571,9172.428571,19163,40140,24750,42834.71429
9/7/2023,7,Agency_7,Thursday,32356,16505,Concert,1,60,48.86,71172,20394,22.13,13299,5864,25506,2282,34640.85714,11204.28571,48861,19163,27788,45845.14286
9/8/2023,7,Agency_7,Friday,37452,13169,Concert,0,60,50.62,71172,20394,21.92,32356,16505,40860,11726,34154,11410.42857,50621,48861,52586,45564.42857
9/9/2023,7,Agency_7,Saturday,28328,13149,Concert,0,60,41.48,71172,20394,26.49,37452,13169,32345,7198,33580.14286,12260.57143,41477,50621,39543,45840.71429
9/10/2023,7,Agency_7,Sunday,36132,7372,None,1,60,43.51,71172,20394,26.63,28328,13149,63691,17061,29643.14286,10876.42857,43504,41477,80752,40519.57143
9/11/2023,7,Agency_7,Monday,16141,8219,None,0,60,24.36,71172,20394,36.04,36132,7372,26865,13006,28111.14286,10192.57143,24360,43504,39871,38303.71429
9/12/2023,7,Agency_7,Tuesday,27478,8779,None,1,60,36.26,71172,20394,29.98,16141,8219,33070,7070,27312.28571,10436.71429,36257,24360,40140,37749
9/13/2023,7,Agency_7,Wednesday,23833,4353,Festival,0,60,28.19,71172,20394,34.9,27478,8779,13299,5864,28817.14286,10220.85714,28186,36257,19163,39038
9/14/2023,7,Agency_7,Thursday,17152,4751,None,0,60,21.9,71172,20394,37.96,23833,4353,32356,16505,26645.14286,8541.714286,21903,28186,48861,35186.85714
9/15/2023,7,Agency_7,Friday,22017,8466,Sports Event,0,60,30.48,71172,20394,32.93,17152,4751,37452,13169,24440.14286,7869.857143,30483,21903,50621,32310
9/16/2023,7,Agency_7,Saturday,27043,8536,Concert,1,60,35.58,71172,20394,30.36,22017,8466,28328,13149,24256.57143,7210.857143,35579,30483,41477,31467.42857
9/17/2023,7,Agency_7,Sunday,54648,19204,Concert,1,60,73.85,71172,20394,9.09,27043,8536,36132,7372,26901.71429,8901.142857,73852,35579,43504,35802.85714
9/18/2023,7,Agency_7,Monday,27060,5038,Festival,0,60,32.1,71172,20394,32.8,54648,19204,16141,8219,28461.57143,8446.714286,32098,73852,24360,36908.28571
9/19/2023,7,Agency_7,Tuesday,19320,5954,None,1,60,25.27,71172,20394,36.03,27060,5038,27478,8779,27296.14286,8043.142857,25274,32098,36257,35339.28571
9/20/2023,7,Agency_7,Wednesday,45282,16317,Festival,1,60,61.6,71172,20394,15.8,19320,5954,23833,4353,30360.28571,9752.285714,61599,25274,28186,40112.57143
9/21/2023,7,Agency_7,Thursday,26275,4578,Sports Event,0,60,30.85,71172,20394,33.52,45282,16317,17152,4751,31663.57143,9727.571429,30853,61599,21903,41391.14286
9/22/2023,7,Agency_7,Friday,32008,5698,Sports Event,0,60,37.71,71172,20394,29.87,26275,4578,22017,8466,33090.85714,9332.142857,37706,30853,30483,42423
9/23/2023,7,Agency_7,Saturday,40734,23669,Festival,1,60,64.4,71172,20394,12.93,32008,5698,27043,8536,35046.71429,11494,64403,37706,35579,46540.71429
9/24/2023,7,Agency_7,Sunday,43443,11746,Concert,0,60,55.19,71172,20394,19.92,40734,23669,54648,19204,33446,10428.57143,55189,64403,73852,43874.57143
9/25/2023,7,Agency_7,Monday,26598,12904,Festival,1,60,39.5,71172,20394,27.53,43443,11746,27060,5038,33380,11552.28571,39502,55189,32098,44932.28571
9/26/2023,7,Agency_7,Tuesday,37969,7221,Sports Event,0,60,45.19,71172,20394,25.82,26598,12904,19320,5954,36044.14286,11733.28571,45190,39502,25274,47777.42857
9/27/2023,7,Agency_7,Wednesday,40132,12894,Concert,0,60,53.03,71172,20394,20.77,37969,7221,45282,16317,35308.42857,11244.28571,53026,45190,61599,46552.71429
9/28/2023,7,Agency_7,Thursday,28318,5610,None,0,60,33.93,71172,20394,31.78,40132,12894,26275,4578,35600.28571,11391.71429,33928,53026,30853,46992
9/29/2023,7,Agency_7,Friday,44725,18630,Sports Event,1,60,63.36,71172,20394,14.46,28318,5610,32008,5698,37417,13239.14286,63355,33928,37706,50656.14286
9/30/2023,7,Agency_7,Saturday,52032,12366,Sports Event,1,60,64.4,71172,20394,15.19,44725,18630,40734,23669,39031,11624.42857,64398,63355,64403,50655.42857
10/1/2023,7,Agency_7,Sunday,41551,16945,Festival,1,60,58.5,71172,20394,17.22,52032,12366,43443,11746,38760.71429,12367.14286,58496,64398,55189,51127.85714
10/2/2023,7,Agency_7,Monday,26416,11216,Concert,1,60,37.63,71172,20394,28.8,41551,16945,26598,12904,38734.71429,12126,37632,58496,39502,50860.71429
10/3/2023,7,Agency_7,Tuesday,49689,1468,Sports Event,1,60,51.16,71172,20394,23.99,26416,11216,37969,7221,40409,11304.14286,51157,37632,45190,51713.14286
10/4/2023,7,Agency_7,Wednesday,41508,12314,Concert,0,60,53.82,71172,20394,20.49,49689,1468,40132,12894,40605.57143,11221.28571,53822,51157,53026,51826.85714
10/5/2023,7,Agency_7,Thursday,26551,10346,Festival,0,60,36.9,71172,20394,29.34,41508,12314,28318,5610,40353.14286,11897.85714,36897,53822,33928,52251
10/6/2023,7,Agency_7,Friday,20015,7459,None,0,60,27.47,71172,20394,34.63,26551,10346,44725,18630,36823.14286,10302,27474,36897,63355,47125.14286
10/7/2023,7,Agency_7,Saturday,38864,4002,None,1,60,42.87,71172,20394,27.63,20015,7459,52032,12366,34942,9107.142857,42866,27474,64398,44049.14286
10/8/2023,7,Agency_7,Sunday,27523,5964,None,0,60,33.49,71172,20394,31.93,38864,4002,41551,16945,32938,7538.428571,33487,42866,58496,40476.42857
10/9/2023,7,Agency_7,Monday,39807,8432,Sports Event,1,60,48.24,71172,20394,24.06,27523,5964,26416,11216,34851,7140.714286,48239,33487,37632,41991.71429
10/10/2023,7,Agency_7,Tuesday,37362,9912,None,1,60,47.27,71172,20394,24.24,39807,8432,49689,1468,33090,8347,47274,48239,51157,41437
10/11/2023,7,Agency_7,Wednesday,24451,3961,Festival,0,60,28.41,71172,20394,34.86,37362,9912,41508,12314,30653.28571,7153.714286,28412,47274,53822,37807
10/12/2023,7,Agency_7,Thursday,18071,5869,None,0,60,23.94,71172,20394,36.72,24451,3961,26551,10346,29441.85714,6514.142857,23940,28412,36897,35956
10/13/2023,7,Agency_7,Friday,41341,17864,Festival,1,60,59.21,71172,20394,16.69,18071,5869,20015,7459,32488.42857,8000.571429,59205,23940,27474,40489
10/14/2023,7,Agency_7,Saturday,37360,12628,None,1,60,49.99,71172,20394,22.34,41341,17864,38864,4002,32273.57143,9232.857143,49988,59205,42866,41506.42857
10/15/2023,7,Agency_7,Sunday,50623,6871,Festival,1,60,57.5,71172,20394,19.74,37360,12628,27523,5964,35573.57143,9362.428571,57494,49988,33487,44936
10/16/2023,7,Agency_7,Monday,19021,7120,None,0,60,26.14,71172,20394,35.37,50623,6871,39807,8432,32604.14286,9175,26141,57494,48239,41779.14286
10/17/2023,7,Agency_7,Tuesday,38496,14294,Festival,1,60,52.79,71172,20394,20.61,19021,7120,37362,9912,32766.14286,9801,52790,26141,47274,42567.14286
10/18/2023,7,Agency_7,Wednesday,27609,4998,Sports Event,0,60,32.61,71172,20394,32.56,38496,14294,24451,3961,33217.28571,9949.142857,32607,52790,28412,43166.42857
10/19/2023,7,Agency_7,Thursday,29074,9550,Concert,0,60,38.63,71172,20394,28.64,27609,4998,18071,5869,34789.14286,10475,38624,32607,23940,45264.14286
10/20/2023,7,Agency_7,Friday,32605,10776,Festival,1,60,43.38,71172,20394,26.02,29074,9550,41341,17864,33541.14286,9462.428571,43381,38624,59205,43003.57143
10/21/2023,7,Agency_7,Saturday,35806,22394,Sports Event,1,60,58.2,71172,20394,16.28,32605,10776,37360,12628,33319.14286,10857.57143,58200,43381,49988,44176.71429
10/22/2023,7,Agency_7,Sunday,22232,10276,None,0,60,32.51,71172,20394,31.55,35806,22394,50623,6871,29263.28571,11344,32508,58200,57494,40607.28571
10/23/2023,7,Agency_7,Monday,41464,8222,Sports Event,0,60,49.69,71172,20394,23.37,22232,10276,19021,7120,32469.42857,11501.42857,49686,32508,26141,43970.85714
10/24/2023,7,Agency_7,Tuesday,29166,1970,Sports Event,1,60,31.14,71172,20394,33.9,41464,8222,38496,14294,31136.57143,9740.857143,31136,49686,52790,40877.42857
10/25/2023,7,Agency_7,Wednesday,24646,5359,Sports Event,1,60,30.01,71172,20394,33.79,29166,1970,27609,4998,30713.28571,9792.428571,30005,31136,32607,40505.71429
10/26/2023,7,Agency_7,Thursday,34959,7323,None,1,60,42.28,71172,20394,27.26,24646,5359,29074,9550,31554,9474.285714,42282,30005,38624,41028.28571
10/27/2023,7,Agency_7,Friday,32922,950,Festival,0,60,33.87,71172,20394,32.74,34959,7323,32605,10776,31599.28571,8070.571429,33872,42282,43381,39669.85714
10/28/2023,7,Agency_7,Saturday,32783,20958,Concert,1,60,53.74,71172,20394,18.8,32922,950,35806,22394,31167.42857,7865.428571,53741,33872,58200,39032.85714
10/29/2023,7,Agency_7,Sunday,38579,10398,Festival,0,60,48.98,71172,20394,23.29,32783,20958,22232,10276,33502.71429,7882.857143,48977,53741,32508,41385.57143
10/30/2023,7,Agency_7,Monday,44506,19684,Concert,1,60,64.19,71172,20394,13.83,38579,10398,41464,8222,33937.28571,9520.285714,64190,48977,49686,43457.57143
10/31/2023,7,Agency_7,Tuesday,24562,7193,None,1,60,31.76,71172,20394,32.55,44506,19684,29166,1970,33279.57143,10266.42857,31755,64190,31136,43546
11/1/2023,7,Agency_7,Wednesday,31443,16632,Sports Event,0,60,48.08,71172,20394,22.5,24562,7193,24646,5359,34250.57143,11876.85714,48075,31755,30005,46127.42857
11/2/2023,7,Agency_7,Thursday,14254,10822,Sports Event,0,60,25.08,71172,20394,35.16,31443,16632,34959,7323,31292.71429,12376.71429,25076,48075,42282,43669.42857
11/3/2023,7,Agency_7,Friday,25252,8586,None,1,60,33.84,71172,20394,31.23,14254,10822,32922,950,30197,13467.57143,33838,25076,33872,43664.57143
11/4/2023,7,Agency_7,Saturday,30083,10833,Festival,0,60,40.92,71172,20394,27.24,25252,8586,32783,20958,29811.28571,12021.14286,40916,33838,53741,41832.42857
11/5/2023,7,Agency_7,Sunday,55123,34730,Festival,1,60,89.85,71172,20394,-2.01,30083,10833,38579,10398,32174.71429,15497.14286,89853,40916,48977,47671.85714
11/6/2023,7,Agency_7,Monday,31252,4624,None,1,60,35.88,71172,20394,31,55123,34730,44506,19684,30281.28571,13345.71429,35876,89853,64190,43627
11/7/2023,7,Agency_7,Tuesday,34867,9741,Concert,1,60,44.61,71172,20394,25.61,31252,4624,24562,7193,31753.42857,13709.71429,44608,35876,31755,45463.14286
11/8/2023,7,Agency_7,Wednesday,21490,10326,Sports Event,1,60,31.82,71172,20394,31.89,34867,9741,31443,16632,30331.57143,12808.85714,31816,44608,48075,43140.42857
11/9/2023,7,Agency_7,Thursday,46144,5833,Concert,1,60,51.98,71172,20394,22.71,21490,10326,14254,10822,34887.28571,12096.14286,51977,31816,25076,46983.42857
11/10/2023,7,Agency_7,Friday,37863,10157,Concert,0,60,48.02,71172,20394,23.82,46144,5833,25252,8586,36688.85714,12320.57143,48020,51977,33838,49009.42857
11/11/2023,7,Agency_7,Saturday,29390,10422,Festival,0,60,39.81,71172,20394,27.87,37863,10157,30083,10833,36589.85714,12261.85714,39812,48020,40916,48851.71429
11/12/2023,7,Agency_7,Sunday,50383,14292,Concert,0,60,64.68,71172,20394,14.67,29390,10422,55123,34730,35912.71429,9342.142857,64675,39812,89853,45254.85714
11/13/2023,7,Agency_7,Monday,30064,7690,Sports Event,0,60,37.76,71172,20394,29.45,50383,14292,31252,4624,35743,9780.142857,37754,64675,35876,45523.14286
11/14/2023,7,Agency_7,Tuesday,30574,6759,Sports Event,0,60,37.33,71172,20394,29.84,30064,7690,34867,9741,35129.71429,9354.142857,37333,37754,44608,44483.85714
11/15/2023,7,Agency_7,Wednesday,18478,21619,Concert,1,60,40.1,71172,20394,25.49,30574,6759,21490,10326,34699.42857,10967.42857,40097,37333,31816,45666.85714
11/16/2023,7,Agency_7,Thursday,40513,13794,Sports Event,1,60,54.31,71172,20394,19.95,18478,21619,46144,5833,33895,12104.71429,54307,40097,51977,45999.71429
11/17/2023,7,Agency_7,Friday,29565,5999,Festival,0,60,35.56,71172,20394,30.88,40513,13794,37863,10157,32709.57143,11510.71429,35564,54307,48020,44220.28571
11/18/2023,7,Agency_7,Saturday,22884,2341,None,0,60,25.23,71172,20394,36.78,29565,5999,29390,10422,31780.14286,10356.28571,25225,35564,39812,42136.42857
11/19/2023,7,Agency_7,Sunday,56493,5591,Concert,0,60,62.08,71172,20394,17.7,22884,2341,50383,14292,32653,9113.285714,62084,25225,64675,41766.28571
11/20/2023,7,Agency_7,Monday,28938,9803,Sports Event,1,60,38.74,71172,20394,28.53,56493,5591,30064,7690,32492.14286,9415.142857,38741,62084,37754,41907.28571
11/21/2023,7,Agency_7,Tuesday,26440,5029,None,0,60,31.47,71172,20394,33.12,28938,9803,30574,6759,31901.57143,9168,31469,38741,37333,41069.57143
11/22/2023,7,Agency_7,Wednesday,20728,12763,Festival,0,60,33.49,71172,20394,30.56,26440,5029,18478,21619,32223,7902.857143,33491,31469,40097,40125.85714
11/23/2023,7,Agency_7,Thursday,30751,8506,None,1,60,39.26,71172,20394,28.53,20728,12763,40513,13794,30828.42857,7147.428571,39257,33491,54307,37975.85714
11/24/2023,7,Agency_7,Friday,35367,16639,Sports Event,0,60,52.01,71172,20394,20.53,30751,8506,29565,5999,31657.28571,8667.428571,52006,39257,35564,40324.71429
11/25/2023,7,Agency_7,Saturday,48243,6599,None,1,60,54.84,71172,20394,21.12,35367,16639,22884,2341,35280,9275.714286,54842,52006,25225,44555.71429
11/26/2023,7,Agency_7,Sunday,43865,10494,None,1,60,54.36,71172,20394,20.58,48243,6599,56493,5591,33476,9976.142857,54359,54842,62084,43452.14286
11/27/2023,7,Agency_7,Monday,43865,3843,Concert,1,60,47.71,71172,20394,25.24,43865,10494,28938,9803,35608.42857,9124.714286,47708,54359,38741,44733.14286
11/28/2023,7,Agency_7,Tuesday,28722,5735,Concert,0,60,34.46,71172,20394,31.49,43865,3843,26440,5029,35934.42857,9225.571429,34457,47708,31469,45160
11/29/2023,7,Agency_7,Wednesday,47073,16997,Festival,1,60,64.07,71172,20394,14.43,28722,5735,20728,12763,39698,9830.428571,64070,34457,33491,49528.42857
11/30/2023,7,Agency_7,Thursday,18772,11792,Festival,1,60,30.57,71172,20394,32.22,47073,16997,30751,8506,37986.71429,10299.85714,30564,64070,39257,48286.57143
12/1/2023,7,Agency_7,Friday,33291,6476,None,1,60,39.77,71172,20394,28.68,18772,11792,35367,16639,37690.14286,8848,39767,30564,52006,46538.14286
12/2/2023,7,Agency_7,Saturday,42561,12601,Concert,0,60,55.16,71172,20394,19.76,33291,6476,48243,6599,36878.42857,9705.428571,55162,39767,54842,46583.85714
12/3/2023,7,Agency_7,Sunday,39074,9849,Festival,0,60,48.92,71172,20394,23.43,42561,12601,43865,10494,36194,9613.285714,48923,55162,54359,45807.28571
12/4/2023,7,Agency_7,Monday,13917,2756,None,0,60,16.67,71172,20394,40.97,39074,9849,43865,3843,31915.71429,9458,16673,48923,47708,41373.71429
12/5/2023,7,Agency_7,Tuesday,45914,11990,Concert,1,60,57.91,71172,20394,18.51,13917,2756,28722,5735,34371.71429,10351.57143,57904,16673,34457,44723.28571
12/6/2023,7,Agency_7,Wednesday,37648,9881,Festival,1,60,47.53,71172,20394,24.12,45914,11990,47073,16997,33025.28571,9335,47529,57904,64070,42360.28571
12/7/2023,7,Agency_7,Thursday,36024,16881,Concert,1,60,52.91,71172,20394,20.03,37648,9881,18772,11792,35489.85714,10062,52905,47529,30564,45551.85714
12/8/2023,7,Agency_7,Friday,27484,3938,Concert,0,60,31.42,71172,20394,33.36,36024,16881,33291,6476,34660.28571,9699.428571,31422,52905,39767,44359.71429
12/9/2023,7,Agency_7,Saturday,37000,8353,None,1,60,45.35,71172,20394,25.51,27484,3938,42561,12601,33865.85714,9092.571429,45353,31422,55162,42958.42857
12/10/2023,7,Agency_7,Sunday,47165,25417,Festival,1,60,72.58,71172,20394,8.49,37000,8353,39074,9849,35021.71429,11316.57143,72582,45353,48923,46338.28571
12/11/2023,7,Agency_7,Monday,19897,5578,None,0,60,25.48,71172,20394,36.01,47165,25417,13917,2756,35876,11719.71429,25475,72582,16673,47595.71429
12/12/2023,7,Agency_7,Tuesday,18336,6384,None,1,60,24.72,71172,20394,36.22,19897,5578,45914,11990,31936.28571,10918.85714,24720,25475,57904,42855.14286
12/13/2023,7,Agency_7,Wednesday,23047,1889,None,0,60,24.94,71172,20394,37.02,18336,6384,37648,9881,29850.42857,9777.142857,24936,24720,47529,39627.57143
12/14/2023,7,Agency_7,Thursday,31506,8841,Sports Event,0,60,40.35,71172,20394,27.92,23047,1889,36024,16881,29205,8628.571429,40347,24936,52905,37833.57143
12/15/2023,7,Agency_7,Friday,26267,9903,None,1,60,36.17,71172,20394,29.8,31506,8841,27484,3938,29031.14286,9480.714286,36170,40347,31422,38511.85714
12/16/2023,7,Agency_7,Saturday,39009,17582,Sports Event,0,60,56.59,71172,20394,18.05,26267,9903,37000,8353,29318.14286,10799.14286,56591,36170,45353,40117.28571
12/17/2023,7,Agency_7,Sunday,35174,16308,Sports Event,1,60,51.48,71172,20394,20.86,39009,17582,47165,25417,27605.14286,9497.857143,51482,56591,72582,37103
12/18/2023,7,Agency_7,Monday,39822,6809,Festival,1,60,46.63,71172,20394,25.18,35174,16308,19897,5578,30451.57143,9673.714286,46631,51482,25475,40125.28571
12/19/2023,7,Agency_7,Tuesday,37171,16403,Concert,0,60,53.57,71172,20394,19.79,39822,6809,18336,6384,33142.28571,11105,53574,46631,24720,44247.28571
12/20/2023,7,Agency_7,Wednesday,29871,10217,Sports Event,0,60,40.09,71172,20394,27.77,37171,16403,23047,1889,34117.14286,12294.71429,40088,53574,24936,46411.85714
12/21/2023,7,Agency_7,Thursday,26548,5000,None,1,60,31.55,71172,20394,33.09,29871,10217,31506,8841,33408.85714,11746,31548,40088,40347,45154.85714
12/22/2023,7,Agency_7,Friday,14164,5023,None,1,60,19.19,71172,20394,39.26,26548,5000,26267,9903,31679.85714,11048.85714,19187,31548,36170,42728.71429
12/23/2023,7,Agency_7,Saturday,30513,26014,Festival,1,60,56.53,71172,20394,16.39,14164,5023,39009,17582,30466.14286,12253.42857,56527,19187,56591,42719.57143
12/24/2023,7,Agency_7,Sunday,34963,9520,Sports Event,0,60,44.48,71172,20394,25.72,30513,26014,35174,16308,30436,11283.71429,44483,56527,51482,41719.71429
12/25/2023,7,Agency_7,Monday,36667,4685,Concert,0,60,41.35,71172,20394,28.25,34963,9520,39822,6809,29985.28571,10980.28571,41352,44483,46631,40965.57143
12/26/2023,7,Agency_7,Tuesday,31521,12223,Festival,1,60,43.75,71172,20394,25.54,36667,4685,37171,16403,29178.14286,10383.14286,43744,41352,53574,39561.28571
12/27/2023,7,Agency_7,Wednesday,37714,10205,Sports Event,0,60,47.92,71172,20394,23.86,31521,12223,29871,10217,30298.57143,10381.42857,47919,43744,40088,40680
12/28/2023,7,Agency_7,Thursday,41419,12271,Festival,1,60,53.69,71172,20394,20.56,37714,10205,26548,5000,32423,11420.14286,53690,47919,31548,43843.14286
12/29/2023,7,Agency_7,Friday,42901,12859,Sports Event,1,60,55.76,71172,20394,19.41,41419,12271,14164,5023,36528.28571,12539.57143,55760,53690,19187,49067.85714
12/30/2023,7,Agency_7,Saturday,17820,6619,None,0,60,24.44,71172,20394,36.32,42901,12859,30513,26014,34715,9768.857143,24439,55760,56527,44483.85714
12/31/2023,7,Agency_7,Sunday,26335,11408,Sports Event,0,60,37.74,71172,20394,28.71,17820,6619,34963,9520,33482.42857,10038.57143,37743,24439,44483,43521
1/8/2023,8,Agency_8,Sunday,42201,8026,Concert,0,168,50.23,73032,41368,38.75,33679,10740,41174,31181,29833.42857,7914.285714,50227,44419,72355,37747.71429
1/9/2023,8,Agency_8,Monday,36330,11830,Sports Event,1,168,48.16,73032,41368,39.03,42201,8026,29700,3724,30780.57143,9072.285714,48160,50227,33424,39852.85714
1/10/2023,8,Agency_8,Tuesday,26971,7272,None,1,168,34.24,73032,41368,46.9,36330,11830,25127,8453,31044,8903.571429,34243,48160,33580,39947.57143
1/11/2023,8,Agency_8,Wednesday,43251,15915,Concert,1,168,59.17,73032,41368,32.71,26971,7272,36875,5349,31954.85714,10413,59166,34243,42224,42367.85714
1/12/2023,8,Agency_8,Thursday,42827,14058,Sports Event,1,168,56.89,73032,41368,34.22,43251,15915,15713,9286,35828.28571,11094.71429,56885,59166,24999,46923
1/13/2023,8,Agency_8,Friday,18132,8670,Concert,0,168,26.8,73032,41368,50.34,42827,14058,25539,9822,34770.14286,10930.14286,26802,56885,35361,45700.28571
1/14/2023,8,Agency_8,Saturday,34939,11751,None,1,168,46.69,73032,41368,39.78,18132,8670,33679,10740,34950.14286,11074.57143,46690,26802,44419,46024.71429
1/15/2023,8,Agency_8,Sunday,25799,6699,None,1,168,32.5,73032,41368,47.88,34939,11751,42201,8026,32607,10885,32498,46690,50227,43492
1/16/2023,8,Agency_8,Monday,25693,10322,Festival,0,168,36.02,73032,41368,45.4,25799,6699,36330,11830,31087.42857,10669.57143,36015,32498,48160,41757
1/17/2023,8,Agency_8,Tuesday,37753,7114,Sports Event,0,168,44.87,73032,41368,41.62,25693,10322,26971,7272,32627.71429,10647,44867,36015,34243,43274.71429
1/18/2023,8,Agency_8,Wednesday,47851,12485,Festival,1,168,60.34,73032,41368,32.81,37753,7114,43251,15915,33284.85714,10157,60336,44867,59166,43441.85714
1/19/2023,8,Agency_8,Thursday,19378,4577,None,0,168,23.96,73032,41368,52.58,47851,12485,42827,14058,29935,8802.571429,23955,60336,56885,38737.57143
1/20/2023,8,Agency_8,Friday,46279,13449,Sports Event,1,168,59.73,73032,41368,32.92,19378,4577,18132,8670,33956,9485.285714,59728,23955,26802,43441.28571
1/21/2023,8,Agency_8,Saturday,56482,7281,Sports Event,0,168,63.76,73032,41368,32.14,46279,13449,34939,11751,37033.57143,8846.714286,63763,59728,46690,45880.28571
1/22/2023,8,Agency_8,Sunday,27108,5123,None,0,168,32.23,73032,41368,48.33,56482,7281,25799,6699,37220.57143,8621.571429,32231,63763,32498,45842.14286
1/23/2023,8,Agency_8,Monday,23479,8462,Concert,0,168,31.94,73032,41368,47.81,27108,5123,25693,10322,36904.28571,8355.857143,31941,32231,36015,45260.14286
1/24/2023,8,Agency_8,Tuesday,31029,18421,Concert,0,168,49.45,73032,41368,37.06,23479,8462,37753,7114,35943.71429,9971.142857,49450,31941,44867,45914.85714
1/25/2023,8,Agency_8,Wednesday,37204,6518,Sports Event,1,168,43.72,73032,41368,42.31,31029,18421,47851,12485,34422.71429,9118.714286,43722,49450,60336,43541.42857
1/26/2023,8,Agency_8,Thursday,41661,2022,Sports Event,1,168,43.68,73032,41368,43.23,37204,6518,19378,4577,37606,8753.714286,43683,43722,23955,46359.71429
1/27/2023,8,Agency_8,Friday,29310,8554,Concert,0,168,37.86,73032,41368,44.83,41661,2022,46279,13449,35181.85714,8054.428571,37864,43683,59728,43236.28571
1/28/2023,8,Agency_8,Saturday,56096,21494,Festival,1,168,77.59,73032,41368,22.38,29310,8554,56482,7281,35126.71429,10084.85714,77590,37864,63763,45211.57143
1/29/2023,8,Agency_8,Sunday,40907,14535,Festival,1,168,55.44,73032,41368,34.84,56096,21494,27108,5123,37098,11429.42857,55442,77590,32231,48527.42857
1/30/2023,8,Agency_8,Monday,24253,4663,Festival,0,168,28.92,73032,41368,50.08,40907,14535,23479,8462,37208.57143,10886.71429,28916,55442,31941,48095.28571
1/31/2023,8,Agency_8,Tuesday,28013,3432,None,1,168,31.45,73032,41368,49.06,24253,4663,31029,18421,36777.71429,8745.428571,31445,28916,49450,45523.14286
2/1/2023,8,Agency_8,Wednesday,34955,7161,Concert,1,168,42.12,73032,41368,42.98,28013,3432,37204,6518,36456.42857,8837.285714,42116,31445,43722,45293.71429
2/2/2023,8,Agency_8,Thursday,29572,12042,None,1,168,41.62,73032,41368,42.26,34955,7161,41661,2022,34729.42857,10268.71429,41614,42116,43683,44998.14286
2/3/2023,8,Agency_8,Friday,13492,1293,None,0,168,14.79,73032,41368,57.82,29572,12042,29310,8554,32469.71429,9231.428571,14785,41614,37864,41701.14286
2/4/2023,8,Agency_8,Saturday,34875,11118,Festival,0,168,45.99,73032,41368,40.25,13492,1293,56096,21494,29438.14286,7749.142857,45993,14785,77590,37187.28571
2/5/2023,8,Agency_8,Sunday,37967,9076,Festival,0,168,47.04,73032,41368,40.14,34875,11118,40907,14535,29018.14286,6969.285714,47043,45993,55442,35987.42857
2/6/2023,8,Agency_8,Monday,37042,13649,Concert,1,168,50.69,73032,41368,37.4,37967,9076,24253,4663,30845.14286,8253,50691,47043,28916,39098.14286
2/7/2023,8,Agency_8,Tuesday,49143,2591,Sports Event,1,168,51.74,73032,41368,39.09,37042,13649,28013,3432,33863.71429,8132.857143,51734,50691,31445,41996.57143
2/8/2023,8,Agency_8,Wednesday,35402,12916,Sports Event,1,168,48.32,73032,41368,38.73,49143,2591,34955,7161,33927.57143,8955,48318,51734,42116,42882.57143
2/9/2023,8,Agency_8,Thursday,30049,20139,Sports Event,1,168,50.19,73032,41368,36.35,35402,12916,29572,12042,33995.71429,10111.71429,50188,48318,41614,44107.42857
2/10/2023,8,Agency_8,Friday,25233,8358,Concert,0,168,33.59,73032,41368,47.01,30049,20139,13492,1293,35673,11121,33591,50188,14785,46794
2/11/2023,8,Agency_8,Saturday,41004,8435,Sports Event,0,168,49.44,73032,41368,39.07,25233,8358,34875,11118,36548.57143,10737.71429,49439,33591,45993,47286.28571
2/12/2023,8,Agency_8,Sunday,25194,12815,Concert,1,168,38.01,73032,41368,43.91,41004,8435,37967,9076,34723.85714,11271.85714,38009,49439,47043,45995.71429
2/13/2023,8,Agency_8,Monday,49036,10295,Festival,1,168,59.33,73032,41368,33.75,25194,12815,37042,13649,36437.28571,10792.71429,59331,38009,50691,47230
2/14/2023,8,Agency_8,Tuesday,30745,16305,Concert,1,168,47.05,73032,41368,38.69,49036,10295,49143,2591,33809,12751.85714,47050,59331,51734,46560.85714
2/15/2023,8,Agency_8,Wednesday,27519,6764,Concert,0,168,34.28,73032,41368,46.98,30745,16305,35402,12916,32682.85714,11873,34283,47050,48318,44555.85714
2/16/2023,8,Agency_8,Thursday,20747,6541,None,0,168,27.29,73032,41368,50.52,27519,6764,30049,20139,31354,9930.428571,27288,34283,50188,41284.42857
2/17/2023,8,Agency_8,Friday,31908,6654,None,0,168,38.56,73032,41368,44.86,20747,6541,25233,8358,32307.57143,9687,38562,27288,33591,41994.57143
2/18/2023,8,Agency_8,Saturday,60369,12338,Sports Event,1,168,72.71,73032,41368,26.65,31908,6654,41004,8435,35074,10244.57143,72707,38562,49439,45318.57143
2/19/2023,8,Agency_8,Sunday,26766,11324,Concert,0,168,38.09,73032,41368,44.16,60369,12338,25194,12815,35298.57143,10031.57143,38090,72707,38009,45330.14286
2/20/2023,8,Agency_8,Monday,40043,6763,Concert,1,168,46.81,73032,41368,40.72,26766,11324,49036,10295,34013.85714,9527,46806,38090,59331,43540.85714
2/21/2023,8,Agency_8,Tuesday,37289,13799,Sports Event,1,168,51.09,73032,41368,37.17,40043,6763,30745,16305,34948.71429,9169,51088,46806,47050,44117.71429
2/22/2023,8,Agency_8,Wednesday,42511,14299,Concert,1,168,56.81,73032,41368,34.21,37289,13799,27519,6764,37090.42857,10245.42857,56810,51088,34283,47335.85714
2/23/2023,8,Agency_8,Thursday,41835,9484,Sports Event,1,168,51.32,73032,41368,37.92,42511,14299,20747,6541,40103,10665.85714,51319,56810,27288,50768.85714
2/24/2023,8,Agency_8,Friday,33988,6192,Sports Event,1,168,40.18,73032,41368,44.14,41835,9484,31908,6654,40400.14286,10599.85714,40180,51319,38562,51000
2/25/2023,8,Agency_8,Saturday,52061,11107,Concert,0,168,63.17,73032,41368,31.67,33988,6192,60369,12338,39213.28571,10424,63168,40180,72707,49637.28571
2/26/2023,8,Agency_8,Sunday,33975,6943,Sports Event,0,168,40.92,73032,41368,43.63,52061,11107,26766,11324,40243.14286,9798.142857,40918,63168,38090,50041.28571
2/27/2023,8,Agency_8,Monday,52017,4850,Sports Event,0,168,56.87,73032,41368,36.07,33975,6943,40043,6763,41953.71429,9524.857143,56867,40918,46806,51478.57143
2/28/2023,8,Agency_8,Tuesday,34817,13877,Festival,1,168,48.7,73032,41368,38.35,52017,4850,37289,13799,41600.57143,9536,48694,56867,51088,51136.57143
3/1/2023,8,Agency_8,Wednesday,34501,11755,Festival,0,168,46.26,73032,41368,39.99,34817,13877,42511,14299,40456.28571,9172.571429,46256,48694,56810,49628.85714
3/2/2023,8,Agency_8,Thursday,37749,8416,None,1,168,46.17,73032,41368,40.71,34501,11755,41835,9484,39872.57143,9020,46165,46256,51319,48892.57143
3/3/2023,8,Agency_8,Friday,22078,7626,Festival,0,168,29.7,73032,41368,49.1,37749,8416,33988,6192,38171.14286,9224.857143,29704,46165,40180,47396
3/4/2023,8,Agency_8,Saturday,38770,20190,Sports Event,0,168,58.96,73032,41368,31.96,22078,7626,52061,11107,36272.42857,10522.42857,58960,29704,63168,46794.85714
3/5/2023,8,Agency_8,Sunday,30443,22911,Concert,1,168,53.35,73032,41368,34.21,38770,20190,33975,6943,35767.85714,12803.57143,53354,58960,40918,48571.42857
3/6/2023,8,Agency_8,Monday,31348,11347,Sports Event,0,168,42.7,73032,41368,41.86,30443,22911,52017,4850,32815.14286,13731.71429,42695,53354,56867,46546.85714
3/7/2023,8,Agency_8,Tuesday,19490,3315,None,0,168,22.8,73032,41368,53.41,31348,11347,34817,13877,30625.57143,12222.85714,22805,42695,48694,42848.42857
3/8/2023,8,Agency_8,Wednesday,35631,10723,Sports Event,0,168,46.35,73032,41368,40.15,19490,3315,34501,11755,30787,12075.42857,46354,22805,46256,42862.42857
3/9/2023,8,Agency_8,Thursday,37290,8454,Festival,0,168,45.74,73032,41368,40.91,35631,10723,37749,8416,30721.42857,12080.85714,45744,46354,46165,42802.28571
3/10/2023,8,Agency_8,Friday,25500,3199,Festival,0,168,28.7,73032,41368,50.48,37290,8454,22078,7626,31210.28571,11448.42857,28699,45744,29704,42658.71429
3/11/2023,8,Agency_8,Saturday,56384,18090,Sports Event,1,168,74.48,73032,41368,24.62,25500,3199,38770,20190,33726.57143,11148.42857,74474,28699,58960,44875
3/12/2023,8,Agency_8,Sunday,35500,12134,Sports Event,1,168,47.63,73032,41368,39.23,56384,18090,30443,22911,34449,9608.857143,47634,74474,53354,44057.85714
3/13/2023,8,Agency_8,Monday,34448,4840,Sports Event,1,168,39.29,73032,41368,44.86,35500,12134,31348,11347,34891.85714,8679.285714,39288,47634,42695,43571.14286
3/14/2023,8,Agency_8,Tuesday,31026,6502,Festival,1,168,37.53,73032,41368,45.41,34448,4840,19490,3315,36539.85714,9134.571429,37528,39288,22805,45674.42857
3/15/2023,8,Agency_8,Wednesday,26905,5987,Concert,0,168,32.89,73032,41368,47.83,31026,6502,35631,10723,35293.28571,8458,32892,37528,46354,43751.28571
3/16/2023,8,Agency_8,Thursday,23134,21527,Festival,1,168,44.66,73032,41368,38.84,26905,5987,37290,8454,33271,10325.57143,44661,32892,45744,43596.57143
3/17/2023,8,Agency_8,Friday,34140,4817,None,1,168,38.96,73032,41368,45.03,23134,21527,25500,3199,34505.28571,10556.71429,38957,44661,28699,45062
3/18/2023,8,Agency_8,Saturday,38451,12893,Concert,0,168,51.34,73032,41368,37.22,34140,4817,56384,18090,31943.42857,9814.285714,51344,38957,74474,41757.71429
3/19/2023,8,Agency_8,Sunday,46719,7430,Festival,0,168,54.15,73032,41368,36.91,38451,12893,35500,12134,33546.14286,9142.285714,54149,51344,47634,42688.42857
3/20/2023,8,Agency_8,Monday,49647,9291,Festival,1,168,58.94,73032,41368,34.15,46719,7430,34448,4840,35717.42857,9778.142857,58938,54149,39288,45495.57143
3/21/2023,8,Agency_8,Tuesday,13320,6448,None,0,168,19.77,73032,41368,54.3,49647,9291,31026,6502,33188,9770.428571,19768,58938,37528,42958.42857
3/22/2023,8,Agency_8,Wednesday,34388,14245,None,1,168,48.63,73032,41368,38.31,13320,6448,26905,5987,34257,10950.14286,48633,19768,32892,45207.14286
3/23/2023,8,Agency_8,Thursday,21001,10874,Festival,0,168,31.88,73032,41368,47.36,34388,14245,23134,21527,33952.28571,9428.285714,31875,48633,44661,43380.57143
3/24/2023,8,Agency_8,Friday,35002,15627,Festival,1,168,50.63,73032,41368,37.03,21001,10874,34140,4817,34075.42857,10972.57143,50629,31875,38957,45048
3/25/2023,8,Agency_8,Saturday,22764,5467,Festival,0,168,28.23,73032,41368,50.26,35002,15627,38451,12893,31834.42857,9911.714286,28231,50629,51344,41746.14286
3/26/2023,8,Agency_8,Sunday,19344,6704,None,0,168,26.05,73032,41368,51.11,22764,5467,46719,7430,27923.71429,9808,26048,28231,54149,37731.71429
3/27/2023,8,Agency_8,Monday,32748,15036,Concert,1,168,47.79,73032,41368,38.57,19344,6704,49647,9291,25509.57143,10628.71429,47784,26048,58938,36138.28571
3/28/2023,8,Agency_8,Tuesday,37701,10538,Festival,0,168,48.24,73032,41368,39.25,32748,15036,13320,6448,28992.57143,11213,48239,47784,19768,40205.57143
3/29/2023,8,Agency_8,Wednesday,42139,9912,Festival,0,168,52.05,73032,41368,37.46,37701,10538,34388,14245,30099.85714,10594,52051,48239,48633,40693.85714
3/30/2023,8,Agency_8,Thursday,20872,13134,Sports Event,0,168,34.01,73032,41368,45.84,42139,9912,21001,10874,30081.42857,10916.85714,34006,52051,31875,40998.28571
3/31/2023,8,Agency_8,Friday,22066,9548,None,1,168,31.61,73032,41368,47.76,20872,13134,35002,15627,28233.42857,10048.42857,31614,34006,50629,38281.85714
4/1/2023,8,Agency_8,Saturday,33441,7686,None,0,168,41.13,73032,41368,43.37,22066,9548,22764,5467,29758.71429,10365.42857,41127,31614,28231,40124.14286
4/2/2023,8,Agency_8,Sunday,29294,9786,Concert,1,168,39.08,73032,41368,43.98,33441,7686,19344,6704,31180.14286,10805.71429,39080,41127,26048,41985.85714
4/3/2023,8,Agency_8,Monday,51895,11093,Sports Event,1,168,62.99,73032,41368,31.76,29294,9786,32748,15036,33915.42857,10242.42857,62988,39080,47784,44157.85714
4/4/2023,8,Agency_8,Tuesday,39774,15510,Concert,1,168,55.28,73032,41368,34.73,51895,11093,37701,10538,34211.57143,10952.71429,55284,62988,48239,45164.28571
4/5/2023,8,Agency_8,Wednesday,35221,9446,Concert,0,168,44.67,73032,41368,41.25,39774,15510,42139,9912,33223.28571,10886.14286,44667,55284,52051,44109.42857
4/6/2023,8,Agency_8,Thursday,28434,7435,Festival,0,168,35.87,73032,41368,46.05,35221,9446,20872,13134,34303.57143,10072,35869,44667,34006,44375.57143
4/7/2023,8,Agency_8,Friday,36433,10381,Festival,0,168,46.82,73032,41368,39.99,28434,7435,22066,9548,36356,10191,46814,35869,31614,46547
4/8/2023,8,Agency_8,Saturday,22455,9313,None,0,168,31.77,73032,41368,47.73,36433,10381,33441,7686,34786.57143,10423.42857,31768,46814,41127,45210
4/9/2023,8,Agency_8,Sunday,45288,10197,Sports Event,1,168,55.49,73032,41368,35.69,22455,9313,29294,9786,37071.42857,10482.14286,55485,31768,39080,47553.57143
4/10/2023,8,Agency_8,Monday,31599,7239,Sports Event,1,168,38.84,73032,41368,44.61,45288,10197,51895,11093,34172,9931.571429,38838,55485,62988,44103.57143
4/11/2023,8,Agency_8,Tuesday,27955,12693,Sports Event,0,168,40.65,73032,41368,42.61,31599,7239,39774,15510,32483.57143,9529.142857,40648,38838,55284,42012.71429
4/12/2023,8,Agency_8,Wednesday,31149,12794,Sports Event,1,168,43.94,73032,41368,40.94,27955,12693,35221,9446,31901.85714,10007.42857,43943,40648,44667,41909.28571
4/13/2023,8,Agency_8,Thursday,32596,10660,Sports Event,1,168,43.26,73032,41368,41.71,31149,12794,28434,7435,32496.42857,10468.14286,43256,43943,35869,42964.57143
4/14/2023,8,Agency_8,Friday,24275,10848,Concert,1,168,35.12,73032,41368,45.74,32596,10660,36433,10381,30759.57143,10534.85714,35123,43256,46814,41294.42857
4/15/2023,8,Agency_8,Saturday,29688,11065,None,1,168,40.75,73032,41368,42.88,24275,10848,22455,9313,31792.85714,10785.14286,40753,35123,31768,42578
4/16/2023,8,Agency_8,Sunday,49411,8053,Sports Event,1,168,57.47,73032,41368,35.13,29688,11065,45288,10197,32381.85714,10478.85714,57464,40753,55485,42860.71429
4/17/2023,8,Agency_8,Monday,38130,9214,Festival,0,168,47.34,73032,41368,39.96,49411,8053,31599,7239,33314.85714,10761,47344,57464,38838,44075.85714
4/18/2023,8,Agency_8,Tuesday,27288,6973,None,1,168,34.26,73032,41368,46.95,38130,9214,27955,12693,33219.57143,9943.857143,34261,47344,40648,43163.42857
4/19/2023,8,Agency_8,Wednesday,33951,12935,Sports Event,1,168,46.89,73032,41368,39.44,27288,6973,31149,12794,33619.85714,9964,46886,34261,43943,43583.85714
4/20/2023,8,Agency_8,Thursday,43635,3584,Festival,1,168,47.22,73032,41368,41.15,33951,12935,32596,10660,35196.85714,8953.142857,47219,46886,43256,44150
4/21/2023,8,Agency_8,Friday,25959,7633,Festival,0,168,33.59,73032,41368,47.15,43635,3584,24275,10848,35437.42857,8493.857143,33592,47219,35123,43931.28571
4/22/2023,8,Agency_8,Saturday,49795,22852,Festival,1,168,72.65,73032,41368,24.58,25959,7633,29688,11065,38309.85714,10177.71429,72647,33592,40753,48487.57143
4/23/2023,8,Agency_8,Sunday,29053,8848,Sports Event,0,168,37.9,73032,41368,44.75,49795,22852,49411,8053,35401.57143,10291.28571,37901,72647,57464,45692.85714
4/24/2023,8,Agency_8,Monday,34002,8082,Concert,1,168,42.08,73032,41368,42.81,29053,8848,38130,9214,34811.85714,10129.57143,42084,37901,47344,44941.42857
4/25/2023,8,Agency_8,Tuesday,35614,15567,Concert,1,168,51.18,73032,41368,36.77,34002,8082,27288,6973,36001.28571,11357.28571,51181,42084,34261,47358.57143
4/26/2023,8,Agency_8,Wednesday,14730,5855,None,0,168,20.59,73032,41368,54.01,35614,15567,33951,12935,33255.42857,10345.85714,20585,51181,46886,43601.28571
4/27/2023,8,Agency_8,Thursday,11490,3877,None,0,168,15.37,73032,41368,57.01,14730,5855,43635,3584,28663.28571,10387.71429,15367,20585,47219,39051
4/28/2023,8,Agency_8,Friday,27528,14193,Sports Event,0,168,41.72,73032,41368,41.77,11490,3877,25959,7633,28887.42857,11324.85714,41721,15367,33592,40212.28571
4/29/2023,8,Agency_8,Saturday,29055,1086,None,1,168,30.14,73032,41368,50.19,27528,14193,49795,22852,25924.57143,8215.428571,30141,41721,72647,34140
4/30/2023,8,Agency_8,Sunday,18009,11200,Festival,0,168,29.21,73032,41368,48.63,29055,1086,29053,8848,24346.85714,8551.428571,29209,30141,37901,32898.28571
5/1/2023,8,Agency_8,Monday,44982,13685,Festival,1,168,58.67,73032,41368,33.4,18009,11200,34002,8082,25915.42857,9351.857143,58667,29209,42084,35267.28571
5/2/2023,8,Agency_8,Tuesday,31255,12450,Concert,0,168,43.71,73032,41368,41.13,44982,13685,35614,15567,25292.71429,8906.571429,43705,58667,51181,34199.28571
5/3/2023,8,Agency_8,Wednesday,17302,6789,None,0,168,24.09,73032,41368,52.07,31255,12450,14730,5855,25660.14286,9040,24091,43705,20585,34700.14286
5/4/2023,8,Agency_8,Thursday,11839,3190,None,0,168,15.03,73032,41368,57.32,17302,6789,11490,3877,25710,8941.857143,15029,24091,15367,34651.85714
5/5/2023,8,Agency_8,Friday,10964,4450,None,0,168,15.41,73032,41368,56.88,11839,3190,27528,14193,23343.71429,7550,15414,15029,41721,30893.71429
5/6/2023,8,Agency_8,Saturday,23721,6796,None,0,168,30.52,73032,41368,48.86,10964,4450,29055,1086,22581.71429,8365.714286,30517,15414,30141,30947.42857
5/7/2023,8,Agency_8,Sunday,36556,6948,Sports Event,0,168,43.5,73032,41368,42.33,23721,6796,18009,11200,25231.28571,7758.285714,43504,30517,29209,32989.57143
5/8/2023,8,Agency_8,Monday,19048,2005,None,0,168,21.05,73032,41368,54.55,36556,6948,44982,13685,21526.42857,6089.714286,21053,43504,58667,27616.14286
5/9/2023,8,Agency_8,Tuesday,52291,10452,Festival,1,168,62.74,73032,41368,32.01,19048,2005,31255,12450,24531.57143,5804.285714,62743,21053,43705,30335.85714
5/10/2023,8,Agency_8,Wednesday,26332,13900,Sports Event,0,168,40.23,73032,41368,42.58,52291,10452,17302,6789,25821.57143,6820.142857,40232,62743,24091,32641.71429
5/11/2023,8,Agency_8,Thursday,26886,6540,Sports Event,1,168,33.43,73032,41368,47.45,26332,13900,11839,3190,27971.14286,7298.714286,33426,40232,15029,35269.85714
5/12/2023,8,Agency_8,Friday,28310,11576,Sports Event,1,168,39.89,73032,41368,43.22,26886,6540,10964,4450,30449.14286,8316.714286,39886,33426,15414,38765.85714
5/13/2023,8,Agency_8,Saturday,39884,14318,Festival,0,168,54.2,73032,41368,35.51,28310,11576,23721,6796,32758.14286,9391.285714,54202,39886,30517,42149.42857
5/14/2023,8,Agency_8,Sunday,51260,911,None,1,168,52.17,73032,41368,39.21,39884,14318,36556,6948,34858.71429,8528.857143,52171,54202,43504,43387.57143
5/15/2023,8,Agency_8,Monday,29955,5439,None,1,168,35.39,73032,41368,46.69,51260,911,19048,2005,36416.85714,9019.428571,35394,52171,21053,45436.28571
5/16/2023,8,Agency_8,Tuesday,33280,8948,Sports Event,1,168,42.23,73032,41368,42.57,29955,5439,52291,10452,33701,8804.571429,42228,35394,62743,42505.57143
5/17/2023,8,Agency_8,Wednesday,20092,11716,None,1,168,31.81,73032,41368,47.23,33280,8948,26332,13900,32809.57143,8492.571429,31808,42228,40232,41302.14286
5/18/2023,8,Agency_8,Thursday,36316,8578,Festival,0,168,44.89,73032,41368,41.31,20092,11716,26886,6540,34156.71429,8783.714286,44894,31808,33426,42940.42857
5/19/2023,8,Agency_8,Friday,40132,3355,Sports Event,0,168,43.49,73032,41368,43.06,36316,8578,28310,11576,35845.57143,7609.285714,43487,44894,39886,43454.85714
5/20/2023,8,Agency_8,Saturday,24022,1423,Sports Event,0,168,25.45,73032,41368,52.47,40132,3355,39884,14318,33579.57143,5767.142857,25445,43487,54202,39346.71429
5/21/2023,8,Agency_8,Sunday,29703,11763,Sports Event,0,168,41.47,73032,41368,42.39,24022,1423,51260,911,30500,7317.428571,41466,25445,52171,37817.42857
5/22/2023,8,Agency_8,Monday,30771,9006,Sports Event,0,168,39.78,73032,41368,43.78,29703,11763,29955,5439,30616.57143,7827,39777,41466,35394,38443.57143
5/23/2023,8,Agency_8,Tuesday,25240,15722,Concert,1,168,40.96,73032,41368,41.85,30771,9006,33280,8948,29468,8794.714286,40962,39777,42228,38262.71429
5/24/2023,8,Agency_8,Wednesday,31797,10992,Concert,0,168,42.79,73032,41368,41.88,25240,15722,20092,11716,31140.14286,8691.285714,42789,40962,31808,39831.42857
5/25/2023,8,Agency_8,Thursday,20545,13380,Sports Event,1,168,33.93,73032,41368,45.83,31797,10992,36316,8578,28887.14286,9377.285714,33925,42789,44894,38264.42857
5/26/2023,8,Agency_8,Friday,14061,4205,None,0,168,18.27,73032,41368,55.5,20545,13380,40132,3355,25162.71429,9498.714286,18266,33925,43487,34661.42857
5/27/2023,8,Agency_8,Saturday,27205,6736,None,0,168,33.94,73032,41368,47.16,14061,4205,24022,1423,25617.42857,10257.71429,33941,18266,25445,35875.14286
5/28/2023,8,Agency_8,Sunday,36836,15507,Festival,1,168,52.34,73032,41368,36.2,27205,6736,29703,11763,26636.42857,10792.57143,52343,33941,41466,37429
5/29/2023,8,Agency_8,Monday,16044,10220,None,1,168,26.26,73032,41368,50.3,36836,15507,30771,9006,24532.57143,10966,26264,52343,39777,35498.57143
5/30/2023,8,Agency_8,Tuesday,28459,12302,Concert,0,168,40.76,73032,41368,42.63,16044,10220,25240,15722,24992.42857,10477.42857,40761,26264,40962,35469.85714
5/31/2023,8,Agency_8,Wednesday,22577,5532,None,1,168,28.11,73032,41368,50.31,28459,12302,31797,10992,23675.28571,9697.428571,28109,40761,42789,33372.71429
6/1/2023,8,Agency_8,Thursday,24268,11478,Festival,0,168,35.75,73032,41368,45.3,22577,5532,20545,13380,24207.14286,9425.714286,35746,28109,33925,33632.85714
6/2/2023,8,Agency_8,Friday,32081,14967,Festival,1,168,47.05,73032,41368,38.96,24268,11478,14061,4205,26781.42857,10963.14286,47048,35746,18266,37744.57143
6/3/2023,8,Agency_8,Saturday,28215,1907,None,1,168,30.12,73032,41368,50.03,32081,14967,27205,6736,26925.71429,10273.28571,30122,47048,33941,37199
6/4/2023,8,Agency_8,Sunday,40126,8171,Sports Event,1,168,48.3,73032,41368,39.69,28215,1907,36836,15507,27395.71429,9225.285714,48297,30122,52343,36621
6/5/2023,8,Agency_8,Monday,30253,4452,Sports Event,0,168,34.71,73032,41368,47.23,40126,8171,16044,10220,29425.57143,8401.285714,34705,48297,26264,37826.85714
6/6/2023,8,Agency_8,Tuesday,36943,8188,Concert,0,168,45.13,73032,41368,41.27,30253,4452,28459,12302,30637.57143,7813.571429,45131,34705,40761,38451.14286
6/7/2023,8,Agency_8,Wednesday,37268,15020,Sports Event,1,168,52.29,73032,41368,36.33,36943,8188,22577,5532,32736.28571,9169,52288,45131,28109,41905.28571
6/8/2023,8,Agency_8,Thursday,32264,6942,None,1,168,39.21,73032,41368,44.48,37268,15020,24268,11478,33878.57143,8521,39206,52288,35746,42399.57143
6/9/2023,8,Agency_8,Friday,31478,3455,Festival,1,168,34.93,73032,41368,47.32,32264,6942,32081,14967,33792.42857,6876.428571,34933,39206,47048,40668.85714
6/10/2023,8,Agency_8,Saturday,29824,8320,Sports Event,0,168,38.14,73032,41368,44.74,31478,3455,28215,1907,34022.28571,7792.571429,38144,34933,30122,41814.85714
6/11/2023,8,Agency_8,Sunday,32034,7842,None,1,168,39.88,73032,41368,43.97,29824,8320,40126,8171,32866.28571,7745.571429,39876,38144,48297,40611.85714
6/12/2023,8,Agency_8,Monday,35158,6415,Festival,0,168,41.57,73032,41368,43.4,32034,7842,30253,4452,33567,8026,41573,39876,34705,41593
6/13/2023,8,Agency_8,Tuesday,38442,17533,Sports Event,1,168,55.98,73032,41368,33.98,35158,6415,36943,8188,33781.14286,9361,55975,41573,45131,43142.14286
6/14/2023,8,Agency_8,Wednesday,32563,8294,Concert,0,168,40.86,73032,41368,43.39,38442,17533,37268,15020,33109,8400.142857,40857,55975,52288,41509.14286
6/15/2023,8,Agency_8,Thursday,22087,5226,None,1,168,27.31,73032,41368,50.77,32563,8294,32264,6942,31655.14286,8155,27313,40857,39206,39810.14286
6/16/2023,8,Agency_8,Friday,30704,9322,Concert,1,168,40.03,73032,41368,43.6,22087,5226,31478,3455,31544.57143,8993.142857,40026,27313,34933,40537.71429
6/17/2023,8,Agency_8,Saturday,42800,10068,Sports Event,0,168,52.87,73032,41368,37.03,30704,9322,29824,8320,33398.28571,9242.857143,52868,40026,38144,42641.14286
6/18/2023,8,Agency_8,Sunday,31007,26410,Festival,1,168,57.42,73032,41368,31.48,42800,10068,32034,7842,33251.57143,11895.42857,57417,52868,39876,45147
6/19/2023,8,Agency_8,Monday,28078,3060,None,1,168,31.14,73032,41368,49.29,31007,26410,35158,6415,32240.14286,11416.14286,31138,57417,41573,43656.28571
6/20/2023,8,Agency_8,Tuesday,26685,8875,Concert,0,168,35.56,73032,41368,45.92,28078,3060,38442,17533,30560.57143,10179.28571,35560,31138,55975,40739.85714
6/21/2023,8,Agency_8,Wednesday,28522,2783,None,0,168,31.3,73032,41368,49.26,26685,8875,32563,8294,29983.28571,9392,31305,35560,40857,39375.28571
6/22/2023,8,Agency_8,Thursday,24880,7798,None,0,168,32.68,73032,41368,47.58,28522,2783,22087,5226,30382.28571,9759.428571,32678,31305,27313,40141.71429
6/23/2023,8,Agency_8,Friday,32869,10576,Sports Event,1,168,43.45,73032,41368,41.64,24880,7798,30704,9322,30691.57143,9938.571429,43445,32678,40026,40630.14286
6/24/2023,8,Agency_8,Saturday,23116,8359,None,1,168,31.48,73032,41368,48.06,32869,10576,42800,10068,27879.57143,9694.428571,31475,43445,52868,37574
6/25/2023,8,Agency_8,Sunday,46371,19550,Sports Event,1,168,65.92,73032,41368,28.6,23116,8359,31007,26410,30074.42857,8714.428571,65921,31475,57417,38788.85714
6/26/2023,8,Agency_8,Monday,25450,3503,None,0,168,28.95,73032,41368,50.3,46371,19550,28078,3060,29699,8777.714286,28953,65921,31138,38476.71429
6/27/2023,8,Agency_8,Tuesday,15244,8426,Festival,0,168,23.67,73032,41368,51.95,25450,3503,26685,8875,28064.57143,8713.571429,23670,28953,35560,36778.14286
6/28/2023,8,Agency_8,Wednesday,32200,9346,Festival,0,168,41.55,73032,41368,42.83,15244,8426,28522,2783,28590,9651.142857,41546,23670,31305,38241.14286
6/29/2023,8,Agency_8,Thursday,27549,8923,Sports Event,0,168,36.47,73032,41368,45.45,32200,9346,24880,7798,28971.28571,9811.857143,36472,41546,32678,38783.14286
6/30/2023,8,Agency_8,Friday,53775,13715,Concert,1,168,67.49,73032,41368,28.98,27549,8923,32869,10576,31957.85714,10260.28571,67490,36472,43445,42218.14286
7/1/2023,8,Agency_8,Saturday,32639,8837,Concert,0,168,41.48,73032,41368,42.97,53775,13715,23116,8359,33318.28571,10328.57143,41476,67490,31475,43646.85714
7/2/2023,8,Agency_8,Sunday,22980,10754,None,0,168,33.73,73032,41368,46.46,32639,8837,46371,19550,29976.71429,9072,33734,41476,65921,39048.71429
7/3/2023,8,Agency_8,Monday,37211,11804,Concert,1,168,49.02,73032,41368,38.6,22980,10754,25450,3503,31656.85714,10257.85714,49015,33734,28953,41914.71429
7/4/2023,8,Agency_8,Tuesday,22864,10075,None,1,168,32.94,73032,41368,46.99,37211,11804,15244,8426,32745.42857,10493.42857,32939,49015,23670,43238.85714
7/5/2023,8,Agency_8,Wednesday,29799,5901,None,0,168,35.7,73032,41368,46.44,22864,10075,32200,9346,32402.42857,10001.28571,35700,32939,41546,42403.71429
7/6/2023,8,Agency_8,Thursday,30619,8624,Concert,0,168,39.24,73032,41368,44.13,29799,5901,27549,8923,32841,9958.571429,39243,35700,36472,42799.57143
7/7/2023,8,Agency_8,Friday,12117,11033,Concert,0,168,23.15,73032,41368,51.69,30619,8624,53775,13715,26889.85714,9575.428571,23150,39243,67490,36465.28571
7/8/2023,8,Agency_8,Saturday,37206,12941,Festival,0,168,50.15,73032,41368,37.81,12117,11033,32639,8837,27542.28571,10161.71429,50147,23150,41476,37704
7/9/2023,8,Agency_8,Sunday,29595,9350,Sports Event,0,168,38.95,73032,41368,44.13,37206,12941,22980,10754,28487.28571,9961.142857,38945,50147,33734,38448.42857
7/10/2023,8,Agency_8,Monday,17944,7043,None,0,168,24.99,73032,41368,51.57,29595,9350,37211,11804,25734.85714,9281,24987,38945,49015,35015.85714
7/11/2023,8,Agency_8,Tuesday,23537,12831,None,1,168,36.37,73032,41368,44.72,17944,7043,22864,10075,25831,9674.714286,36368,24987,32939,35505.71429
7/12/2023,8,Agency_8,Wednesday,33231,4161,Concert,0,168,37.39,73032,41368,45.94,23537,12831,29799,5901,26321.28571,9426.142857,37392,36368,35700,35747.42857
7/13/2023,8,Agency_8,Thursday,37746,8796,Concert,1,168,46.54,73032,41368,40.44,33231,4161,30619,8624,27339.42857,9450.714286,46542,37392,39243,36790.14286
7/14/2023,8,Agency_8,Friday,17604,19511,Festival,1,168,37.12,73032,41368,43.01,37746,8796,12117,11033,28123.28571,10661.85714,37115,46542,23150,38785.14286
7/15/2023,8,Agency_8,Saturday,42327,13405,Festival,0,168,55.73,73032,41368,34.93,17604,19511,37206,12941,28854.85714,10728.14286,55732,37115,50147,39583
7/16/2023,8,Agency_8,Sunday,48735,6915,Concert,1,168,55.65,73032,41368,36.27,42327,13405,29595,9350,31589.14286,10380.28571,55650,55732,38945,41969.42857
7/17/2023,8,Agency_8,Monday,26371,11361,Concert,0,168,37.73,73032,41368,44.34,48735,6915,17944,7043,32793,10997.14286,37732,55650,24987,43790.14286
7/18/2023,8,Agency_8,Tuesday,28748,0,Concert,1,168,28.75,73032,41368,51.1,26371,11361,23537,12831,33537.42857,9164.142857,28748,37732,36368,42701.57143
7/19/2023,8,Agency_8,Wednesday,18864,4716,None,0,168,23.58,73032,41368,52.74,28748,0,33231,4161,31485,9243.428571,23580,28748,37392,40728.42857
7/20/2023,8,Agency_8,Thursday,31015,10976,Festival,0,168,41.99,73032,41368,42.28,18864,4716,37746,8796,30523.42857,9554.857143,41991,23580,46542,40078.28571
7/21/2023,8,Agency_8,Friday,34782,9378,Sports Event,0,168,44.16,73032,41368,41.52,31015,10976,17604,19511,32977.42857,8107.285714,44160,41991,37115,41084.71429
7/22/2023,8,Agency_8,Saturday,46758,4336,Festival,0,168,51.09,73032,41368,39.06,34782,9378,42327,13405,33610.42857,6811.714286,51094,44160,55732,40422.14286
7/23/2023,8,Agency_8,Sunday,40539,13819,Sports Event,0,168,54.36,73032,41368,35.53,46758,4336,48735,6915,32439.57143,7798,54358,51094,55650,40237.57143
7/24/2023,8,Agency_8,Monday,13802,1994,None,0,168,15.8,73032,41368,57.18,40539,13819,26371,11361,30644,6459.857143,15796,54358,37732,37103.85714
7/25/2023,8,Agency_8,Tuesday,21151,5146,None,1,168,26.3,73032,41368,51.3,13802,1994,28748,0,29558.71429,7195,26297,15796,28748,36753.71429
7/26/2023,8,Agency_8,Wednesday,35650,6409,Concert,0,168,42.06,73032,41368,43.16,21151,5146,18864,4716,31956.71429,7436.857143,42059,26297,23580,39393.57143
7/27/2023,8,Agency_8,Thursday,23577,6419,Sports Event,0,168,30,73032,41368,49.19,35650,6409,31015,10976,30894.14286,6785.857143,29996,42059,41991,37680
7/28/2023,8,Agency_8,Friday,25593,5026,None,0,168,30.62,73032,41368,49.16,23577,6419,34782,9378,29581.42857,6164.142857,30619,29996,44160,35745.57143
7/29/2023,8,Agency_8,Saturday,34385,10561,Concert,0,168,44.95,73032,41368,40.89,25593,5026,46758,4336,27813.85714,7053.428571,44946,30619,51094,34867.28571
7/30/2023,8,Agency_8,Sunday,61916,10832,Festival,1,168,72.75,73032,41368,26.93,34385,10561,40539,13819,30867.71429,6626.714286,72748,44946,54358,37494.42857
7/31/2023,8,Agency_8,Monday,39865,9214,Sports Event,0,168,49.08,73032,41368,39.09,61916,10832,13802,1994,34591,7658.142857,49079,72748,15796,42249.14286
8/1/2023,8,Agency_8,Tuesday,28795,17001,Concert,0,168,45.8,73032,41368,39.17,39865,9214,21151,5146,35683,9351.714286,45796,49079,26297,45034.71429
8/2/2023,8,Agency_8,Wednesday,28705,10214,Festival,1,168,38.92,73032,41368,43.97,28795,17001,35650,6409,34690.85714,9895.285714,38919,45796,42059,44586.14286
8/3/2023,8,Agency_8,Thursday,20755,11736,Sports Event,0,168,32.49,73032,41368,46.88,28705,10214,23577,6419,34287.71429,10654.85714,32491,38919,29996,44942.57143
8/4/2023,8,Agency_8,Friday,42667,14176,Concert,0,168,56.84,73032,41368,34.22,20755,11736,25593,5026,36726.85714,11962,56843,32491,30619,48688.85714
8/5/2023,8,Agency_8,Saturday,61118,14244,Concert,1,168,75.36,73032,41368,24.94,42667,14176,34385,10561,40545.85714,12488.14286,75362,56843,44946,53034
8/6/2023,8,Agency_8,Sunday,28349,3015,None,1,168,31.37,73032,41368,49.19,61118,14244,61916,10832,35750.57143,11371.42857,31364,75362,72748,47122
8/7/2023,8,Agency_8,Monday,58849,14130,Festival,1,168,72.98,73032,41368,26.16,28349,3015,39865,9214,38462.57143,12073.71429,72979,31364,49079,50536.28571
8/8/2023,8,Agency_8,Tuesday,17540,7656,None,0,168,25.2,73032,41368,51.34,58849,14130,28795,17001,36854.71429,10738.71429,25196,72979,45796,47593.42857
8/9/2023,8,Agency_8,Wednesday,22704,9882,Concert,0,168,32.59,73032,41368,47.2,17540,7656,28705,10214,35997.42857,10691.28571,32586,25196,38919,46688.71429
8/10/2023,8,Agency_8,Thursday,24876,8787,None,1,168,33.66,73032,41368,46.88,22704,9882,20755,11736,36586.14286,10270,33663,32586,32491,46856.14286
8/11/2023,8,Agency_8,Friday,38379,4993,Concert,1,168,43.37,73032,41368,42.79,24876,8787,42667,14176,35973.57143,8958.142857,43372,33663,56843,44931.71429
8/12/2023,8,Agency_8,Saturday,47682,21958,Concert,1,168,69.64,73032,41368,26.26,38379,4993,61118,14244,34054.14286,10060.14286,69640,43372,75362,44114.28571
8/13/2023,8,Agency_8,Sunday,23823,8515,None,0,168,32.34,73032,41368,47.6,47682,21958,28349,3015,33407.57143,10845.85714,32338,69640,31364,44253.42857
8/14/2023,8,Agency_8,Monday,14772,4947,None,0,168,19.72,73032,41368,54.62,23823,8515,58849,14130,27110.85714,9534,19719,32338,72979,36644.85714
8/15/2023,8,Agency_8,Tuesday,32910,15453,Sports Event,1,168,48.36,73032,41368,38.2,14772,4947,17540,7656,29306.57143,10647.85714,48363,19719,25196,39954.42857
8/16/2023,8,Agency_8,Wednesday,30235,10846,Concert,0,168,41.08,73032,41368,42.76,32910,15453,22704,9882,30382.42857,10785.57143,41081,48363,32586,41168
8/17/2023,8,Agency_8,Thursday,25438,6383,None,0,168,31.82,73032,41368,48.29,30235,10846,24876,8787,30462.71429,10442.14286,31821,41081,33663,40904.85714
8/18/2023,8,Agency_8,Friday,41661,7147,Festival,1,168,48.81,73032,41368,39.64,25438,6383,38379,4993,30931.57143,10749.85714,48808,31821,43372,41681.42857
8/19/2023,8,Agency_8,Saturday,46767,12168,Concert,1,168,58.94,73032,41368,33.57,41661,7147,47682,21958,30800.85714,9351.285714,58935,48808,69640,40152.14286
8/20/2023,8,Agency_8,Sunday,42772,13149,Festival,1,168,55.92,73032,41368,34.88,46767,12168,23823,8515,33507.85714,10013.28571,55921,58935,32338,43521.14286
8/21/2023,8,Agency_8,Monday,22650,1844,Sports Event,0,168,24.49,73032,41368,52.86,42772,13149,14772,4947,34633.28571,9570,24494,55921,19719,44203.28571
8/22/2023,8,Agency_8,Tuesday,16659,5386,None,0,168,22.05,73032,41368,53.37,22650,1844,32910,15453,32311.71429,8131.857143,22045,24494,48363,40443.57143
8/23/2023,8,Agency_8,Wednesday,19888,8552,Concert,0,168,28.44,73032,41368,49.54,16659,5386,30235,10846,30833.57143,7804.142857,28440,22045,41081,38637.71429
8/24/2023,8,Agency_8,Thursday,38351,9864,None,1,168,48.22,73032,41368,39.39,19888,8552,25438,6383,32678.28571,8301.428571,48215,28440,31821,40979.71429
8/25/2023,8,Agency_8,Friday,28217,5782,None,0,168,34,73032,41368,47.32,38351,9864,41661,7147,30757.71429,8106.428571,33999,48215,48808,38864.14286
8/26/2023,8,Agency_8,Saturday,60458,10989,Concert,1,168,71.45,73032,41368,27.55,28217,5782,46767,12168,32713.57143,7938,71447,33999,58935,40651.57143
8/27/2023,8,Agency_8,Sunday,39260,0,Festival,1,168,39.26,73032,41368,45.84,60458,10989,42772,13149,32211.85714,6059.571429,39260,71447,55921,38271.42857
8/28/2023,8,Agency_8,Monday,50563,19230,Concert,1,168,69.79,73032,41368,26.73,39260,0,22650,1844,36199.42857,8543.285714,69793,39260,24494,44742.71429
8/29/2023,8,Agency_8,Tuesday,25851,7636,Concert,0,168,33.49,73032,41368,47.2,50563,19230,16659,5386,37512.57143,8864.714286,33487,69793,22045,46377.28571
8/30/2023,8,Agency_8,Wednesday,24345,9800,Festival,0,168,34.15,73032,41368,46.44,25851,7636,19888,8552,38149.28571,9043,34145,33487,28440,47192.28571
8/31/2023,8,Agency_8,Thursday,25624,1514,None,0,168,27.14,73032,41368,51.6,24345,9800,38351,9864,36331.14286,7850.142857,27138,34145,48215,44181.28571
9/1/2023,8,Agency_8,Friday,33070,7558,Sports Event,0,168,40.63,73032,41368,43.65,25624,1514,28217,5782,37024.42857,8103.857143,40628,27138,33999,45128.28571
9/2/2023,8,Agency_8,Saturday,37018,13076,Sports Event,0,168,50.1,73032,41368,37.81,33070,7558,60458,10989,33675.85714,8402,50094,40628,71447,42077.85714
9/3/2023,8,Agency_8,Sunday,29730,8721,None,1,168,38.45,73032,41368,44.5,37018,13076,39260,0,32314.42857,9647.857143,38451,50094,39260,41962.28571
9/4/2023,8,Agency_8,Monday,28395,11798,Sports Event,0,168,40.19,73032,41368,43.02,29730,8721,50563,19230,29147.57143,8586.142857,40193,38451,69793,37733.71429
9/5/2023,8,Agency_8,Tuesday,33139,9249,Sports Event,0,168,42.39,73032,41368,42.43,28395,11798,25851,7636,30188.71429,8816.571429,42388,40193,33487,39005.28571
9/6/2023,8,Agency_8,Wednesday,26607,10095,Concert,1,168,36.7,73032,41368,45.1,33139,9249,24345,9800,30511.85714,8858.714286,36702,42388,34145,39370.57143
9/7/2023,8,Agency_8,Thursday,47761,12078,Concert,1,168,59.84,73032,41368,33.14,26607,10095,25624,1514,33674.28571,10367.85714,59839,36702,27138,44042.14286
9/8/2023,8,Agency_8,Friday,34945,14506,Festival,0,168,49.45,73032,41368,37.85,47761,12078,33070,7558,33942.14286,11360.42857,49451,59839,40628,45302.57143
9/9/2023,8,Agency_8,Saturday,45347,11461,Sports Event,0,168,56.81,73032,41368,34.78,34945,14506,37018,13076,35132,11129.71429,56808,49451,50094,46261.71429
9/10/2023,8,Agency_8,Sunday,40821,0,Festival,1,168,40.82,73032,41368,45.06,45347,11461,29730,8721,36716.42857,9883.857143,40821,56808,38451,46600.28571
9/11/2023,8,Agency_8,Monday,37358,10345,Concert,1,168,47.7,73032,41368,39.55,40821,0,28395,11798,37996.85714,9676.285714,47703,40821,40193,47673.14286
9/12/2023,8,Agency_8,Tuesday,32926,7976,Concert,0,168,40.9,73032,41368,43.43,37358,10345,33139,9249,37966.42857,9494.428571,40902,47703,42388,47460.85714
9/13/2023,8,Agency_8,Wednesday,23917,2017,None,1,168,25.93,73032,41368,52.1,32926,7976,26607,10095,37582.14286,8340.428571,25934,40902,36702,45922.57143
9/14/2023,8,Agency_8,Thursday,22950,10120,Concert,0,168,33.07,73032,41368,46.91,23917,2017,47761,12078,34037.71429,8060.714286,33070,25934,59839,42098.42857
9/15/2023,8,Agency_8,Friday,55729,11433,Sports Event,1,168,67.16,73032,41368,29.61,22950,10120,34945,14506,37006.85714,7621.714286,67162,33070,49451,44628.57143
9/16/2023,8,Agency_8,Saturday,38950,15257,Sports Event,0,168,54.21,73032,41368,35.32,55729,11433,45347,11461,36093,8164,54207,67162,56808,44257
9/17/2023,8,Agency_8,Sunday,28701,12669,Festival,0,168,41.37,73032,41368,42.25,38950,15257,40821,0,34361.57143,9973.857143,41370,54207,40821,44335.42857
9/18/2023,8,Agency_8,Monday,24445,11439,Festival,0,168,35.88,73032,41368,45.24,28701,12669,37358,10345,32516.85714,10130.14286,35884,41370,47703,42647
9/19/2023,8,Agency_8,Tuesday,31135,9513,Concert,0,168,40.65,73032,41368,43.25,24445,11439,32926,7976,32261,10349.71429,40648,35884,40902,42610.71429
9/20/2023,8,Agency_8,Wednesday,20913,8979,None,1,168,29.89,73032,41368,48.73,31135,9513,23917,2017,31831.85714,11344.28571,29892,40648,25934,43176.14286
9/21/2023,8,Agency_8,Thursday,45634,5072,Sports Event,0,168,50.71,73032,41368,39.11,20913,8979,22950,10120,35072.42857,10623.14286,50706,29892,33070,45695.57143
9/22/2023,8,Agency_8,Friday,35686,13001,Sports Event,1,168,48.69,73032,41368,38.53,45634,5072,55729,11433,32209.14286,10847.14286,48687,50706,67162,43056.28571
9/23/2023,8,Agency_8,Saturday,43077,8574,Festival,0,168,51.65,73032,41368,37.93,35686,13001,38950,15257,32798.71429,9892.428571,51651,48687,54207,42691.14286
9/24/2023,8,Agency_8,Sunday,10501,17056,Sports Event,0,168,27.56,73032,41368,48.28,43077,8574,28701,12669,30198.71429,10519.14286,27557,51651,41370,40717.85714
9/25/2023,8,Agency_8,Monday,46413,3603,Concert,1,168,50.02,73032,41368,39.74,10501,17056,24445,11439,33337,9399.714286,50016,27557,35884,42736.71429
9/26/2023,8,Agency_8,Tuesday,25443,13831,Sports Event,0,168,39.27,73032,41368,43.07,46413,3603,31135,9513,32523.85714,10016.57143,39274,50016,40648,42540.42857
9/27/2023,8,Agency_8,Wednesday,40857,11690,Concert,0,168,52.55,73032,41368,36.86,25443,13831,20913,8979,35373,10403.85714,52547,39274,29892,45776.85714
9/28/2023,8,Agency_8,Thursday,28678,8780,Sports Event,0,168,37.46,73032,41368,44.99,40857,11690,45634,5072,32950.71429,10933.57143,37458,52547,50706,43884.28571
9/29/2023,8,Agency_8,Friday,25148,10158,None,1,168,35.31,73032,41368,45.79,28678,8780,35686,13001,31445.28571,10527.42857,35306,37458,48687,41972.71429
9/30/2023,8,Agency_8,Saturday,24367,6166,None,1,168,30.53,73032,41368,48.97,25148,10158,43077,8574,28772.42857,10183.42857,30533,35306,51651,38955.85714
10/1/2023,8,Agency_8,Sunday,58619,15194,Sports Event,1,168,73.81,73032,41368,25.53,24367,6166,10501,17056,35646.42857,9917.428571,73813,30533,27557,45563.85714
10/2/2023,8,Agency_8,Monday,34959,5118,None,1,168,40.08,73032,41368,44.41,58619,15194,46413,3603,34010.14286,10133.85714,40077,73813,50016,44144
10/3/2023,8,Agency_8,Tuesday,29589,5363,Sports Event,0,168,34.95,73032,41368,46.92,34959,5118,25443,13831,34602.42857,8924.142857,34952,40077,39274,43526.57143
10/4/2023,8,Agency_8,Wednesday,20036,2042,None,0,168,22.08,73032,41368,54.03,29589,5363,40857,11690,31628,7545.857143,22078,34952,52547,39173.85714
10/5/2023,8,Agency_8,Thursday,26341,3615,Sports Event,0,168,29.96,73032,41368,49.77,20036,2042,28678,8780,31294.14286,6808,29956,22078,37458,38102.14286
10/6/2023,8,Agency_8,Friday,45764,15310,Concert,1,168,61.08,73032,41368,31.87,26341,3615,25148,10158,34239.28571,7544,61074,29956,35306,41783.28571
10/7/2023,8,Agency_8,Saturday,20426,16944,Festival,0,168,37.37,73032,41368,43.4,45764,15310,24367,6166,33676.28571,9083.714286,37370,61074,30533,42760
10/8/2023,8,Agency_8,Sunday,38984,6619,None,0,168,45.6,73032,41368,41.35,20426,16944,58619,15194,30871.28571,7858.714286,45603,37370,73813,38730
10/9/2023,8,Agency_8,Monday,32748,25342,Sports Event,1,168,58.09,73032,41368,31.36,38984,6619,34959,5118,30555.42857,10747.85714,58090,45603,40077,41303.28571
10/10/2023,8,Agency_8,Tuesday,26139,11995,Concert,1,168,38.13,73032,41368,44.01,32748,25342,29589,5363,30062.57143,11695.28571,38134,58090,34952,41757.85714
10/11/2023,8,Agency_8,Wednesday,27167,10766,None,1,168,37.93,73032,41368,44.35,26139,11995,20036,2042,31081.28571,12941.57143,37933,38134,22078,44022.85714
10/12/2023,8,Agency_8,Thursday,32697,6803,Sports Event,0,168,39.5,73032,41368,44.36,27167,10766,26341,3615,31989.28571,13397,39500,37933,29956,45386.28571
10/13/2023,8,Agency_8,Friday,22866,7337,Sports Event,0,168,30.2,73032,41368,48.9,32697,6803,45764,15310,28718.14286,12258,30203,39500,61074,40976.14286
10/14/2023,8,Agency_8,Saturday,35018,15763,Festival,1,168,50.78,73032,41368,36.93,22866,7337,20426,16944,30802.71429,12089.28571,50781,30203,37370,42892
10/15/2023,8,Agency_8,Sunday,20614,2614,None,0,168,23.23,73032,41368,53.34,35018,15763,38984,6619,28178.42857,11517.14286,23228,50781,45603,39695.57143
10/16/2023,8,Agency_8,Monday,51236,9529,Sports Event,1,168,60.77,73032,41368,33.18,20614,2614,32748,25342,30819.57143,9258.142857,60765,23228,58090,40077.71429
10/17/2023,8,Agency_8,Tuesday,17756,6528,None,1,168,24.28,73032,41368,52.03,51236,9529,26139,11995,29622,8477.142857,24284,60765,38134,38099.14286
10/18/2023,8,Agency_8,Wednesday,39664,3586,Sports Event,1,168,43.25,73032,41368,43.13,17756,6528,27167,10766,31407.28571,7451.428571,43250,24284,37933,38858.71429
10/19/2023,8,Agency_8,Thursday,32487,4938,Concert,0,168,37.43,73032,41368,45.77,39664,3586,32697,6803,31377.28571,7185,37425,43250,39500,38562.28571
10/20/2023,8,Agency_8,Friday,42832,10279,Festival,0,168,53.11,73032,41368,36.86,32487,4938,22866,7337,34229.57143,7605.285714,53111,37425,30203,41834.85714
10/21/2023,8,Agency_8,Saturday,32400,7754,Festival,0,168,40.15,73032,41368,43.85,42832,10279,35018,15763,33855.57143,6461.142857,40154,53111,50781,40316.71429
10/22/2023,8,Agency_8,Sunday,30381,11329,None,1,168,41.71,73032,41368,42.35,32400,7754,20614,2614,35250.85714,7706.142857,41710,40154,23228,42957
10/23/2023,8,Agency_8,Monday,38750,10864,Festival,1,168,49.62,73032,41368,38.49,30381,11329,51236,9529,33467.14286,7896.857143,49614,41710,60765,41364
10/24/2023,8,Agency_8,Tuesday,26378,5308,None,1,168,31.69,73032,41368,48.57,38750,10864,17756,6528,34698.85714,7722.571429,31686,49614,24284,42421.42857
10/25/2023,8,Agency_8,Wednesday,27424,1407,Festival,0,168,28.83,73032,41368,50.78,26378,5308,39664,3586,32950.28571,7411.285714,28831,31686,43250,40361.57143
10/26/2023,8,Agency_8,Thursday,24868,5597,None,0,168,30.46,73032,41368,49.12,27424,1407,32487,4938,31861.85714,7505.428571,30465,28831,37425,39367.28571
10/27/2023,8,Agency_8,Friday,31457,20936,Concert,1,168,52.39,73032,41368,35.09,24868,5597,42832,10279,30236.85714,9027.857143,52393,30465,53111,39264.71429
10/28/2023,8,Agency_8,Saturday,36783,6468,Concert,0,168,43.25,73032,41368,42.55,31457,20936,32400,7754,30863,8844.142857,43251,52393,40154,39707.14286
10/29/2023,8,Agency_8,Sunday,43709,12809,Sports Event,0,168,56.52,73032,41368,34.65,36783,6468,30381,11329,32767,9055.571429,56518,43251,41710,41822.57143
10/30/2023,8,Agency_8,Monday,42845,9872,Concert,1,168,52.72,73032,41368,37.14,43709,12809,38750,10864,33352,8913.857143,52717,56518,49614,42265.85714
10/31/2023,8,Agency_8,Tuesday,43391,10652,Festival,1,168,54.04,73032,41368,36.32,42845,9872,26378,5308,35782.42857,9677.285714,54043,52717,31686,45459.71429
11/1/2023,8,Agency_8,Wednesday,44419,2832,Sports Event,1,168,47.25,73032,41368,41.28,43391,10652,27424,1407,38210.28571,9880.857143,47251,54043,28831,48091.14286
11/2/2023,8,Agency_8,Thursday,17830,8444,None,0,168,26.27,73032,41368,50.65,44419,2832,24868,5597,37204.85714,10287.57143,26274,47251,30465,47492.42857
11/3/2023,8,Agency_8,Friday,31519,9024,Festival,1,168,40.54,73032,41368,43.4,17830,8444,31457,20936,37213.71429,8585.857143,40543,26274,52393,45799.57143
11/4/2023,8,Agency_8,Saturday,41558,7951,Sports Event,1,168,49.51,73032,41368,39.13,31519,9024,36783,6468,37895.85714,8797.714286,49509,40543,43251,46693.57143
11/5/2023,8,Agency_8,Sunday,13974,8259,None,1,168,22.23,73032,41368,52.7,41558,7951,43709,12809,33648,8147.714286,22233,49509,56518,41795.71429
11/6/2023,8,Agency_8,Monday,40324,11647,Festival,1,168,51.97,73032,41368,37.16,13974,8259,42845,9872,33287.85714,8401.285714,51971,22233,52717,41689.14286
11/7/2023,8,Agency_8,Tuesday,28912,8646,Festival,0,168,37.56,73032,41368,44.97,40324,11647,43391,10652,31219.42857,8114.714286,37558,51971,54043,39334.14286
11/8/2023,8,Agency_8,Wednesday,48972,10993,Concert,1,168,59.97,73032,41368,33.29,28912,8646,44419,2832,31869.85714,9280.571429,59965,37558,47251,41150.42857
11/9/2023,8,Agency_8,Thursday,17129,4437,None,0,168,21.57,73032,41368,53.8,48972,10993,17830,8444,31769.71429,8708.142857,21566,59965,26274,40477.85714
11/10/2023,8,Agency_8,Friday,34344,13300,Sports Event,0,168,47.64,73032,41368,38.99,17129,4437,31519,9024,32173.28571,9319,47644,21566,40543,41492.28571
11/11/2023,8,Agency_8,Saturday,30346,11485,Festival,0,168,41.83,73032,41368,42.26,34344,13300,41558,7951,30571.57143,9823.857143,41831,47644,49509,40395.42857
11/12/2023,8,Agency_8,Sunday,26029,3918,None,0,168,29.95,73032,41368,49.72,30346,11485,13974,8259,32293.71429,9203.714286,29947,41831,22233,41497.42857
11/13/2023,8,Agency_8,Monday,30153,3515,Festival,0,168,33.67,73032,41368,47.94,26029,3918,40324,11647,30840.71429,8042,33668,29947,51971,38882.71429
11/14/2023,8,Agency_8,Tuesday,21750,13644,Concert,1,168,35.39,73032,41368,45.05,30153,3515,28912,8646,29817.57143,8756,35394,33668,37558,38573.57143
11/15/2023,8,Agency_8,Wednesday,27120,9186,Concert,0,168,36.31,73032,41368,45.48,21750,13644,48972,10993,26695.85714,8497.857143,36306,35394,59965,35193.71429
11/16/2023,8,Agency_8,Thursday,25883,4265,None,1,168,30.15,73032,41368,49.55,27120,9186,17129,4437,27946.42857,8473.285714,30148,36306,21566,36419.71429
11/17/2023,8,Agency_8,Friday,29659,4306,Sports Event,0,168,33.97,73032,41368,47.63,25883,4265,34344,13300,27277.14286,7188.428571,33965,30148,47644,34465.57143
11/18/2023,8,Agency_8,Saturday,63072,7079,Sports Event,1,168,70.15,73032,41368,28.98,29659,4306,30346,11485,31952.28571,6559,70151,33965,41831,38511.28571
11/19/2023,8,Agency_8,Sunday,44509,9019,Sports Event,1,168,53.53,73032,41368,36.91,63072,7079,26029,3918,34592.28571,7287.714286,53528,70151,29947,41880
11/20/2023,8,Agency_8,Monday,29707,6071,None,1,168,35.78,73032,41368,46.37,44509,9019,30153,3515,34528.57143,7652.857143,35778,53528,33668,42181.42857
11/21/2023,8,Agency_8,Tuesday,26109,11400,Concert,0,168,37.51,73032,41368,44.44,29707,6071,21750,13644,35151.28571,7332.285714,37509,35778,35394,42483.57143
11/22/2023,8,Agency_8,Wednesday,20147,6033,None,0,168,26.18,73032,41368,51.18,26109,11400,27120,9186,34155.14286,6881.857143,26180,37509,36306,41037
11/23/2023,8,Agency_8,Thursday,29431,5212,Festival,1,168,34.64,73032,41368,47.11,20147,6033,25883,4265,34662,7017.142857,34643,26180,30148,41679.14286
11/24/2023,8,Agency_8,Friday,40045,10381,Festival,1,168,50.43,73032,41368,38.18,29431,5212,29659,4306,36145.71429,7885,50426,34643,33965,44030.71429
11/25/2023,8,Agency_8,Saturday,54128,14974,Sports Event,1,168,69.1,73032,41368,27.93,40045,10381,63072,7079,34868,9012.857143,69102,50426,70151,43880.85714
11/26/2023,8,Agency_8,Sunday,49198,5423,Sports Event,1,168,54.62,73032,41368,37.08,54128,14974,44509,9019,35537.85714,8499.142857,54621,69102,53528,44037
11/27/2023,8,Agency_8,Monday,57411,11116,Concert,1,168,68.53,73032,41368,28.99,49198,5423,29707,6071,39495.57143,9219.857143,68527,54621,35778,48715.42857
11/28/2023,8,Agency_8,Tuesday,45799,7918,Concert,1,168,53.72,73032,41368,37.03,57411,11116,26109,11400,42308.42857,8722.428571,53717,68527,37509,51030.85714
11/29/2023,8,Agency_8,Wednesday,42003,5697,Concert,1,168,47.7,73032,41368,40.48,45799,7918,20147,6033,45430.71429,8674.428571,47700,53717,26180,54105.14286
11/30/2023,8,Agency_8,Thursday,43407,10205,Festival,1,168,53.61,73032,41368,36.63,42003,5697,29431,5212,47427.28571,9387.714286,53612,47700,34643,56815
12/1/2023,8,Agency_8,Friday,20145,6395,None,0,168,26.54,73032,41368,50.92,43407,10205,40045,10381,44584.42857,8818.285714,26540,53612,50426,53402.71429
12/2/2023,8,Agency_8,Saturday,32378,11234,Festival,1,168,43.61,73032,41368,41.42,20145,6395,54128,14974,41477.28571,8284,43612,26540,69102,49761.28571
12/3/2023,8,Agency_8,Sunday,40114,20323,Sports Event,0,168,60.44,73032,41368,31.19,32378,11234,49198,5423,40179.57143,10412.57143,60437,43612,54621,50592.14286
12/4/2023,8,Agency_8,Monday,37652,14713,Concert,1,168,52.37,73032,41368,36.35,40114,20323,57411,11116,37356.85714,10926.42857,52365,60437,68527,48283.28571
12/5/2023,8,Agency_8,Tuesday,29197,15102,Concert,0,168,44.3,73032,41368,40.3,37652,14713,45799,7918,34985.14286,11952.71429,44299,52365,53717,46937.85714
12/6/2023,8,Agency_8,Wednesday,16894,8821,Concert,0,168,25.72,73032,41368,50.85,29197,15102,42003,5697,31398.14286,12399,25715,44299,47700,43797.14286
12/7/2023,8,Agency_8,Thursday,17808,0,Concert,0,168,17.81,73032,41368,56.57,16894,8821,43407,10205,27741.14286,10941.14286,17808,25715,53612,38682.28571
12/8/2023,8,Agency_8,Friday,27933,7389,None,1,168,35.32,73032,41368,46.33,17808,0,20145,6395,28853.71429,11083.14286,35322,17808,26540,39936.85714
12/9/2023,8,Agency_8,Saturday,43465,14810,Concert,1,168,58.28,73032,41368,33.37,27933,7389,32378,11234,30437.57143,11594,58275,35322,43612,42031.57143
12/10/2023,8,Agency_8,Sunday,83048,13870,Festival,1,168,96.92,73032,41368,14.24,43465,14810,40114,20323,36571,10672.14286,96918,58275,60437,47243.14286
12/11/2023,8,Agency_8,Monday,33825,6291,Concert,0,168,40.12,73032,41368,44.16,83048,13870,37652,14713,36024.28571,9469,40116,96918,52365,45493.28571
12/12/2023,8,Agency_8,Tuesday,27918,6332,None,1,168,34.25,73032,41368,47.08,33825,6291,29197,15102,35841.57143,8216.142857,34250,40116,44299,44057.71429
12/13/2023,8,Agency_8,Wednesday,26920,14682,Festival,0,168,41.6,73032,41368,41.74,27918,6332,16894,8821,37273.85714,9053.428571,41602,34250,25715,46327.28571
12/14/2023,8,Agency_8,Thursday,50475,12549,Festival,1,168,63.03,73032,41368,31.45,26920,14682,17808,0,41940.57143,10846.14286,63024,41602,17808,52786.71429
12/15/2023,8,Agency_8,Friday,16532,10179,Concert,1,168,26.71,73032,41368,50.08,50475,12549,27933,7389,40311.85714,11244.71429,26711,63024,35322,51556.57143
12/16/2023,8,Agency_8,Saturday,40218,5899,None,0,168,46.12,73032,41368,41.24,16532,10179,43465,14810,39848,9971.714286,46117,26711,58275,49819.71429
12/17/2023,8,Agency_8,Sunday,59707,24390,Sports Event,1,168,84.1,73032,41368,18.55,40218,5899,83048,13870,36513.57143,11474.57143,84097,46117,96918,47988.14286
12/18/2023,8,Agency_8,Monday,41133,7892,Concert,1,168,49.03,73032,41368,39.38,59707,24390,33825,6291,37557.57143,11703.28571,49025,84097,40116,49260.85714
12/19/2023,8,Agency_8,Tuesday,11734,10825,Festival,0,168,22.56,73032,41368,52.03,41133,7892,27918,6332,35245.57143,12345.14286,22559,49025,34250,47590.71429
12/20/2023,8,Agency_8,Wednesday,20703,7492,None,1,168,28.2,73032,41368,49.88,11734,10825,26920,14682,34357.42857,11318,28195,22559,41602,45675.42857
12/21/2023,8,Agency_8,Thursday,26812,10636,Festival,1,168,37.45,73032,41368,44.62,20703,7492,50475,12549,30977,11044.71429,37448,28195,63024,42021.71429
12/22/2023,8,Agency_8,Friday,30252,9412,Festival,0,168,39.66,73032,41368,43.76,26812,10636,16532,10179,32937,10935.14286,39664,37448,26711,43872.14286
12/23/2023,8,Agency_8,Saturday,33754,22873,Sports Event,1,168,56.63,73032,41368,32.58,30252,9412,40218,5899,32013.57143,13360,56627,39664,46117,45373.57143
12/24/2023,8,Agency_8,Sunday,26543,3004,None,1,168,29.55,73032,41368,50.1,33754,22873,59707,24390,27275.85714,10304.85714,29547,56627,84097,37580.71429
12/25/2023,8,Agency_8,Monday,19454,5068,None,0,168,24.52,73032,41368,52.2,26543,3004,41133,7892,24178.85714,9901.428571,24522,29547,49025,34080.28571
12/26/2023,8,Agency_8,Tuesday,27042,10813,None,1,168,37.86,73032,41368,44.38,19454,5068,11734,10825,26365.71429,9899.714286,37855,24522,22559,36265.42857
12/27/2023,8,Agency_8,Wednesday,24462,6664,None,1,168,31.13,73032,41368,48.58,27042,10813,20703,7492,26902.71429,9781.428571,31126,37855,28195,36684.14286
12/28/2023,8,Agency_8,Thursday,28243,15805,Concert,1,168,44.05,73032,41368,40.29,24462,6664,26812,10636,27107.14286,10519.85714,44048,31126,37448,37627
12/29/2023,8,Agency_8,Friday,31381,7070,Festival,0,168,38.45,73032,41368,44.83,28243,15805,30252,9412,27268.42857,10185.28571,38451,44048,39664,37453.71429
12/30/2023,8,Agency_8,Saturday,18856,17432,Festival,0,168,36.29,73032,41368,43.84,31381,7070,33754,22873,25140.14286,9408,36288,38451,56627,34548.14286
12/31/2023,8,Agency_8,Sunday,24949,8435,Concert,0,168,33.39,73032,41368,47.09,18856,17432,26543,3004,24912.42857,10183.85714,33384,36288,29547,35096.28571
1/8/2023,9,Agency_9,Sunday,23565,3100,Festival,0,55,26.67,68214,22826,36.13,53962,9411,33993,4742,37597.42857,6693.142857,26665,63373,38735,44290.57143
1/9/2023,9,Agency_9,Monday,17319,9431,Festival,1,55,26.75,68214,22826,34.82,23565,3100,16291,1052,37744.28571,7890.142857,26750,26665,17343,45634.42857
1/10/2023,9,Agency_9,Tuesday,36065,8894,Festival,1,55,44.96,68214,22826,25.83,17319,9431,46027,9303,36321.14286,7831.714286,44959,26750,55330,44152.85714
1/11/2023,9,Agency_9,Wednesday,39325,12675,Sports Event,0,55,52,68214,22826,21.55,36065,8894,51954,5118,34517,8911.285714,52000,44959,57072,43428.28571
1/12/2023,9,Agency_9,Thursday,35733,3360,Concert,1,55,39.09,68214,22826,29.87,39325,12675,30014,9208,35334,8075.857143,39093,52000,39222,43409.85714
1/13/2023,9,Agency_9,Friday,33473,9044,Sports Event,1,55,42.52,68214,22826,27.02,35733,3360,41369,9660,34206,7987.857143,42517,39093,51029,42193.85714
1/14/2023,9,Agency_9,Saturday,30085,7964,Festival,0,55,38.05,68214,22826,29.47,33473,9044,53962,9411,30795,7781.142857,38049,42517,63373,38576.14286
1/15/2023,9,Agency_9,Sunday,39152,13075,Sports Event,1,55,52.23,68214,22826,21.36,30085,7964,23565,3100,33021.71429,9206.142857,52227,38049,26665,42227.85714
1/16/2023,9,Agency_9,Monday,25233,9207,Concert,0,55,34.44,68214,22826,31.02,39152,13075,17319,9431,34152.28571,9174.142857,34440,52227,26750,43326.42857
1/17/2023,9,Agency_9,Tuesday,32701,5402,Concert,0,55,38.1,68214,22826,29.95,25233,9207,36065,8894,33671.71429,8675.285714,38103,34440,44959,42347
1/18/2023,9,Agency_9,Wednesday,51392,7232,Festival,1,55,58.63,68214,22826,19.33,32701,5402,39325,12675,35395.57143,7897.714286,58624,38103,52000,43293.28571
1/19/2023,9,Agency_9,Thursday,17865,9793,Festival,0,55,27.66,68214,22826,34.3,51392,7232,35733,3360,32843,8816.714286,27658,58624,39093,41659.71429
1/20/2023,9,Agency_9,Friday,23868,9591,Sports Event,0,55,33.46,68214,22826,31.44,17865,9793,33473,9044,31470.85714,8894.857143,33459,27658,42517,40365.71429
1/21/2023,9,Agency_9,Saturday,12450,14166,None,1,55,26.62,68214,22826,33.94,23868,9591,30085,7964,28951.57143,9780.857143,26616,33459,38049,38732.42857
1/22/2023,9,Agency_9,Sunday,54664,6184,Festival,1,55,60.85,68214,22826,18.42,12450,14166,39152,13075,31167.57143,8796.428571,60848,26616,52227,39964
1/23/2023,9,Agency_9,Monday,24581,19858,Concert,1,55,44.44,68214,22826,23.89,54664,6184,25233,9207,31074.42857,10318,44439,60848,34440,41392.42857
1/24/2023,9,Agency_9,Tuesday,24469,5662,Concert,0,55,30.13,68214,22826,33.89,24581,19858,32701,5402,29898.42857,10355.14286,30131,44439,38103,40253.57143
1/25/2023,9,Agency_9,Wednesday,16904,10229,Concert,1,55,27.13,68214,22826,34.47,24469,5662,51392,7232,24971.57143,10783.28571,27133,30131,58624,35754.85714
1/26/2023,9,Agency_9,Thursday,36778,15303,Festival,1,55,52.08,68214,22826,20.98,16904,10229,17865,9793,27673.42857,11570.42857,52081,27133,27658,39243.85714
1/27/2023,9,Agency_9,Friday,16905,2742,None,1,55,19.65,68214,22826,39.71,36778,15303,23868,9591,26678.71429,10592,19647,52081,33459,37270.71429
1/28/2023,9,Agency_9,Saturday,52074,21698,Festival,1,55,73.77,68214,22826,8.86,16905,2742,12450,14166,32339.28571,11668,73772,19647,26616,44007.28571
1/29/2023,9,Agency_9,Sunday,21859,15830,Sports Event,0,55,37.69,68214,22826,28.07,52074,21698,54664,6184,27652.85714,13046,37689,73772,60848,40698.85714
1/30/2023,9,Agency_9,Monday,20187,7183,None,0,55,27.37,68214,22826,34.96,21859,15830,24581,19858,27025.14286,11235.28571,27370,37689,44439,38260.42857
1/31/2023,9,Agency_9,Tuesday,38313,0,Concert,1,55,38.31,68214,22826,30.93,20187,7183,24469,5662,29002.85714,10426.42857,38313,27370,30131,39429.28571
2/1/2023,9,Agency_9,Wednesday,37518,16945,Festival,1,55,54.46,68214,22826,19.46,38313,0,16904,10229,31947.71429,11385.85714,54463,38313,27133,43333.57143
2/2/2023,9,Agency_9,Thursday,20190,5913,None,1,55,26.1,68214,22826,35.85,37518,16945,36778,15303,29578,10044.42857,26103,54463,52081,39622.42857
2/3/2023,9,Agency_9,Friday,28678,0,Sports Event,0,55,28.68,68214,22826,35.75,20190,5913,16905,2742,31259.85714,9652.714286,28678,26103,19647,40912.57143
2/4/2023,9,Agency_9,Saturday,51040,7065,Sports Event,0,55,58.11,68214,22826,19.62,28678,0,52074,21698,31112.14286,7562.285714,58105,28678,73772,38674.42857
2/5/2023,9,Agency_9,Sunday,27033,6273,None,0,55,33.31,68214,22826,32.18,51040,7065,21859,15830,31851.28571,6197,33306,58105,37689,38048.28571
2/6/2023,9,Agency_9,Monday,51261,13832,Festival,1,55,65.09,68214,22826,14.77,27033,6273,20187,7183,36290.42857,7146.857143,65093,33306,27370,43437.28571
2/7/2023,9,Agency_9,Tuesday,24472,4496,None,1,55,28.97,68214,22826,34.7,51261,13832,38313,0,34313.14286,7789.142857,28968,65093,38313,42102.28571
2/8/2023,9,Agency_9,Wednesday,46778,2982,Sports Event,1,55,49.76,68214,22826,24.61,24472,4496,37518,16945,35636,5794.428571,49760,28968,54463,41430.42857
2/9/2023,9,Agency_9,Thursday,45296,6666,Festival,1,55,51.96,68214,22826,22.77,46778,2982,20190,5913,39222.57143,5902,51962,49760,26103,45124.57143
2/10/2023,9,Agency_9,Friday,34139,7450,None,1,55,41.59,68214,22826,27.8,45296,6666,28678,0,40002.71429,6966.285714,41589,51962,28678,46969
2/11/2023,9,Agency_9,Saturday,36223,9396,None,1,55,45.62,68214,22826,25.4,34139,7450,51040,7065,37886,7299.285714,45619,41589,58105,45185.28571
2/12/2023,9,Agency_9,Sunday,20228,7244,Concert,0,55,27.47,68214,22826,34.9,36223,9396,27033,6273,36913.85714,7438,27472,45619,33306,44351.85714
2/13/2023,9,Agency_9,Monday,45553,12692,Concert,1,55,58.25,68214,22826,18.42,20228,7244,51261,13832,36098.42857,7275.142857,58245,27472,65093,43373.57143
2/14/2023,9,Agency_9,Tuesday,38856,9870,Sports Event,0,55,48.73,68214,22826,23.75,45553,12692,24472,4496,38153.28571,8042.857143,48726,58245,28968,46196.14286
2/15/2023,9,Agency_9,Wednesday,22749,5791,Festival,0,55,28.54,68214,22826,34.66,38856,9870,46778,2982,34720.57143,8444.142857,28540,48726,49760,43164.71429
2/16/2023,9,Agency_9,Thursday,26668,519,None,1,55,27.19,68214,22826,36.39,22749,5791,45296,6666,32059.42857,7566,27187,28540,51962,39625.42857
2/17/2023,9,Agency_9,Friday,55315,14001,Festival,1,55,69.32,68214,22826,12.63,26668,519,34139,7450,35084.57143,8501.857143,69316,27187,41589,43586.42857
2/18/2023,9,Agency_9,Saturday,47043,4061,Festival,0,55,51.1,68214,22826,23.72,55315,14001,36223,9396,36630.28571,7739.714286,51104,69316,45619,44370
2/19/2023,9,Agency_9,Sunday,61359,29275,Festival,1,55,90.63,68214,22826,-1.09,47043,4061,20228,7244,42506.14286,10887,90634,51104,27472,53393.14286
2/20/2023,9,Agency_9,Monday,13395,6542,None,0,55,19.94,68214,22826,38.81,61359,29275,45553,12692,37912.14286,10008.42857,19937,90634,58245,47920.57143
2/21/2023,9,Agency_9,Tuesday,30007,3248,Concert,0,55,33.26,68214,22826,32.81,13395,6542,38856,9870,36648,9062.428571,33255,19937,48726,45710.42857
2/22/2023,9,Agency_9,Wednesday,43804,15867,Concert,1,55,59.67,68214,22826,17.08,30007,3248,22749,5791,39655.85714,10501.85714,59671,33255,28540,50157.71429
2/23/2023,9,Agency_9,Thursday,33138,17447,Festival,1,55,50.59,68214,22826,21.3,43804,15867,26668,519,40580.14286,12920.14286,50585,59671,27187,53500.28571
2/24/2023,9,Agency_9,Friday,22748,4783,Festival,1,55,27.53,68214,22826,35.36,33138,17447,55315,14001,35927.71429,11603.28571,27531,50585,69316,47531
2/25/2023,9,Agency_9,Saturday,32263,9191,None,1,55,41.45,68214,22826,27.52,22748,4783,47043,4061,33816.28571,12336.14286,41454,27531,51104,46152.42857
2/26/2023,9,Agency_9,Sunday,29550,14627,Concert,0,55,44.18,68214,22826,25.07,32263,9191,61359,29275,29272.14286,10243.57143,44177,41454,90634,39515.71429
2/27/2023,9,Agency_9,Monday,44175,15984,Concert,1,55,60.16,68214,22826,16.81,29550,14627,13395,6542,33669.28571,11592.42857,60159,44177,19937,45261.71429
2/28/2023,9,Agency_9,Tuesday,37798,14767,Festival,1,55,52.57,68214,22826,20.85,44175,15984,30007,3248,34782.28571,13238,52565,60159,33255,48020.28571
3/1/2023,9,Agency_9,Wednesday,34653,21674,Sports Event,1,55,56.33,68214,22826,17.59,37798,14767,43804,15867,33475,14067.57143,56327,52565,59671,47542.57143
3/2/2023,9,Agency_9,Thursday,23905,15657,Concert,0,55,39.56,68214,22826,27.17,34653,21674,33138,17447,32156,13811.85714,39562,56327,50585,45967.85714
3/3/2023,9,Agency_9,Friday,30261,3821,Concert,0,55,34.08,68214,22826,32.28,23905,15657,22748,4783,33229.28571,13674.42857,34082,39562,27531,46903.71429
3/4/2023,9,Agency_9,Saturday,48312,11604,Concert,0,55,59.92,68214,22826,17.81,30261,3821,32263,9191,35522,14019.14286,59916,34082,41454,49541.14286
3/5/2023,9,Agency_9,Sunday,37837,13553,None,1,55,51.39,68214,22826,21.68,48312,11604,29550,14627,36705.85714,13865.71429,51390,59916,44177,50571.57143
3/6/2023,9,Agency_9,Monday,32533,6485,Sports Event,0,55,39.02,68214,22826,29.28,37837,13553,44175,15984,35042.71429,12508.71429,39018,51390,60159,47551.42857
3/7/2023,9,Agency_9,Tuesday,24878,5001,None,0,55,29.88,68214,22826,34.15,32533,6485,37798,14767,33197,11113.57143,29879,39018,52565,44310.57143
3/8/2023,9,Agency_9,Wednesday,30457,968,None,1,55,31.43,68214,22826,34.18,24878,5001,34653,21674,32597.57143,8155.571429,31425,29879,56327,40753.14286
3/9/2023,9,Agency_9,Thursday,43356,8858,Festival,1,55,52.21,68214,22826,22.21,30457,968,23905,15657,35376.28571,7184.285714,52214,31425,39562,42560.57143
3/10/2023,9,Agency_9,Friday,42399,10618,Festival,0,55,53.02,68214,22826,21.45,43356,8858,30261,3821,37110.28571,8155.285714,53017,52214,34082,45265.57143
3/11/2023,9,Agency_9,Saturday,49605,18477,Sports Event,1,55,68.08,68214,22826,12.35,42399,10618,48312,11604,37295,9137.142857,68082,53017,59916,46432.14286
3/12/2023,9,Agency_9,Sunday,35116,25513,Concert,1,55,60.63,68214,22826,14.67,49605,18477,37837,13553,36906.28571,10845.71429,60629,68082,51390,47752
3/13/2023,9,Agency_9,Monday,29956,5785,None,0,55,35.74,68214,22826,31.06,35116,25513,32533,6485,36538.14286,10745.71429,35741,60629,39018,47283.85714
3/14/2023,9,Agency_9,Tuesday,41928,6563,Concert,0,55,48.49,68214,22826,24.53,29956,5785,24878,5001,38973.85714,10968.85714,48491,35741,29879,49942.71429
3/15/2023,9,Agency_9,Wednesday,24021,8637,Concert,0,55,32.66,68214,22826,32.03,41928,6563,30457,968,38054.42857,12064.42857,32658,48491,31425,50118.85714
3/16/2023,9,Agency_9,Thursday,33261,7160,Festival,0,55,40.42,68214,22826,28.44,24021,8637,43356,8858,36612.28571,11821.85714,40421,32658,52214,48434.14286
3/17/2023,9,Agency_9,Friday,34032,9540,Concert,0,55,43.57,68214,22826,26.39,33261,7160,42399,10618,35417,11667.85714,43572,40421,53017,47084.85714
3/18/2023,9,Agency_9,Saturday,23412,10987,None,1,55,34.4,68214,22826,30.69,34032,9540,49605,18477,31675.14286,10597.85714,34399,43572,68082,42273
3/19/2023,9,Agency_9,Sunday,29180,6944,None,0,55,36.12,68214,22826,30.63,23412,10987,35116,25513,30827.14286,7945.142857,36124,34399,60629,38772.28571
3/20/2023,9,Agency_9,Monday,33491,3590,None,1,55,37.08,68214,22826,30.83,29180,6944,29956,5785,31332.14286,7631.571429,37081,36124,35741,38963.71429
3/21/2023,9,Agency_9,Tuesday,33508,4520,Sports Event,0,55,38.03,68214,22826,30.17,33491,3590,41928,6563,30129.28571,7339.714286,38028,37081,48491,37469
3/22/2023,9,Agency_9,Wednesday,21643,6354,Concert,0,55,28,68214,22826,34.82,33508,4520,24021,8637,29789.57143,7013.571429,27997,38028,32658,36803.14286
3/23/2023,9,Agency_9,Thursday,15289,3904,None,0,55,19.19,68214,22826,39.71,21643,6354,33261,7160,27222.14286,6548.428571,19193,27997,40421,33770.57143
3/24/2023,9,Agency_9,Friday,28393,11345,Sports Event,0,55,39.74,68214,22826,27.95,15289,3904,34032,9540,26416.57143,6806.285714,39738,19193,43572,33222.85714
3/25/2023,9,Agency_9,Saturday,33109,4039,Festival,0,55,37.15,68214,22826,30.7,28393,11345,23412,10987,27801.85714,5813.714286,37148,39738,34399,33615.57143
3/26/2023,9,Agency_9,Sunday,40092,6051,None,1,55,46.14,68214,22826,25.8,33109,4039,29180,6944,29360.71429,5686.142857,46143,37148,36124,35046.85714
3/27/2023,9,Agency_9,Monday,19706,5893,None,0,55,25.6,68214,22826,36.11,40092,6051,33491,3590,27391.42857,6015.142857,25599,46143,37081,33406.57143
3/28/2023,9,Agency_9,Tuesday,20998,7188,None,0,55,28.19,68214,22826,34.55,19706,5893,33508,4520,25604.28571,6396.285714,28186,25599,38028,32000.57143
3/29/2023,9,Agency_9,Wednesday,33592,5570,Concert,0,55,39.16,68214,22826,29.39,20998,7188,21643,6354,27311.28571,6284.285714,39162,28186,27997,33595.57143
3/30/2023,9,Agency_9,Thursday,46338,9159,Festival,0,55,55.5,68214,22826,20.5,33592,5570,15289,3904,31746.85714,7035,55497,39162,19193,38781.85714
3/31/2023,9,Agency_9,Friday,19263,6927,None,0,55,26.19,68214,22826,35.6,46338,9159,28393,11345,30442.57143,6403.857143,26190,55497,39738,36846.42857
4/1/2023,9,Agency_9,Saturday,49717,17939,Festival,1,55,67.66,68214,22826,12.67,19263,6927,33109,4039,32815.14286,8389.571429,67656,26190,37148,41204.71429
4/2/2023,9,Agency_9,Sunday,58428,9832,Festival,0,55,68.26,68214,22826,13.99,49717,17939,40092,6051,35434.57143,8929.714286,68260,67656,46143,44364.28571
4/3/2023,9,Agency_9,Monday,27616,8896,Concert,0,55,36.51,68214,22826,30.05,58428,9832,19706,5893,36564.57143,9358.714286,36512,68260,25599,45923.28571
4/4/2023,9,Agency_9,Tuesday,25357,1986,None,0,55,27.34,68214,22826,36.02,27616,8896,20998,7188,37187.28571,8615.571429,27343,36512,28186,45802.85714
4/5/2023,9,Agency_9,Wednesday,15258,6502,Concert,0,55,21.76,68214,22826,37.9,25357,1986,33592,5570,34568.14286,8748.714286,21760,27343,39162,43316.85714
4/6/2023,9,Agency_9,Thursday,17745,7055,Festival,0,55,24.8,68214,22826,36.27,15258,6502,46338,9159,30483.42857,8448.142857,24800,21760,55497,38931.57143
4/7/2023,9,Agency_9,Friday,22512,3218,None,0,55,25.73,68214,22826,36.58,17745,7055,19263,6927,30947.57143,7918.285714,25730,24800,26190,38865.85714
4/8/2023,9,Agency_9,Saturday,30104,15896,Concert,1,55,46,68214,22826,23.91,22512,3218,49717,17939,28145.71429,7626.428571,46000,25730,67656,35772.14286
4/9/2023,9,Agency_9,Sunday,43761,3558,Festival,0,55,47.32,68214,22826,25.71,30104,15896,58428,9832,26050.42857,6730.142857,47319,46000,68260,32780.57143
4/10/2023,9,Agency_9,Monday,36151,11277,Sports Event,0,55,47.43,68214,22826,24.11,43761,3558,27616,8896,27269.71429,7070.285714,47428,47319,36512,34340
4/11/2023,9,Agency_9,Tuesday,48301,17697,Concert,1,55,66,68214,22826,13.55,36151,11277,25357,1986,30547.42857,9314.714286,65998,47428,27343,39862.14286
4/12/2023,9,Agency_9,Wednesday,60469,10203,Sports Event,1,55,70.67,68214,22826,12.71,48301,17697,15258,6502,37006.14286,9843.428571,70672,65998,21760,46849.57143
4/13/2023,9,Agency_9,Thursday,30820,7083,Concert,0,55,37.9,68214,22826,29.72,60469,10203,17745,7055,38874,9847.428571,37903,70672,24800,48721.42857
4/14/2023,9,Agency_9,Friday,30013,13710,Sports Event,0,55,43.72,68214,22826,25.48,30820,7083,22512,3218,39945.57143,11346.28571,43723,37903,25730,51291.85714
4/15/2023,9,Agency_9,Saturday,23893,7242,Festival,0,55,31.14,68214,22826,33.07,30013,13710,30104,15896,39058.28571,10110,31135,43723,46000,49168.28571
4/16/2023,9,Agency_9,Sunday,48393,15558,Sports Event,0,55,63.95,68214,22826,15,23893,7242,43761,3558,39720,11824.28571,63951,31135,47319,51544.28571
4/17/2023,9,Agency_9,Monday,35458,15965,Concert,1,55,51.42,68214,22826,21.18,48393,15558,36151,11277,39621,12494,51423,63951,47428,52115
4/18/2023,9,Agency_9,Tuesday,42326,19040,Festival,1,55,61.37,68214,22826,15.59,35458,15965,48301,17697,38767.42857,12685.85714,61366,51423,65998,51453.28571
4/19/2023,9,Agency_9,Wednesday,20372,7051,None,0,55,27.42,68214,22826,34.96,42326,19040,60469,10203,33039.28571,12235.57143,27423,61366,70672,45274.85714
4/20/2023,9,Agency_9,Thursday,64759,14746,Festival,1,55,79.51,68214,22826,7.38,20372,7051,30820,7083,37887.71429,13330.28571,79505,27423,37903,51218
4/21/2023,9,Agency_9,Friday,26319,9021,None,1,55,35.34,68214,22826,30.61,64759,14746,30013,13710,37360,12660.42857,35340,79505,43723,50020.42857
4/22/2023,9,Agency_9,Saturday,42524,30243,Festival,1,55,72.77,68214,22826,7.65,26319,9021,23893,7242,40021.57143,15946.28571,72767,35340,31135,55967.85714
4/23/2023,9,Agency_9,Sunday,48906,13780,Festival,1,55,62.69,68214,22826,15.99,42524,30243,48393,15558,40094.85714,15692.28571,62686,72767,63951,55787.14286
4/24/2023,9,Agency_9,Monday,30850,17121,Concert,1,55,47.97,68214,22826,22.67,48906,13780,35458,15965,39436.57143,15857.42857,47971,62686,51423,55294
4/25/2023,9,Agency_9,Tuesday,47453,9531,Festival,1,55,56.99,68214,22826,19.69,30850,17121,42326,19040,40169,14499,56984,47971,61366,54668
4/26/2023,9,Agency_9,Wednesday,34323,3369,Concert,0,55,37.69,68214,22826,30.57,47453,9531,20372,7051,42162,13973,37692,56984,27423,56135
4/27/2023,9,Agency_9,Thursday,40801,14053,Sports Event,1,55,54.86,68214,22826,19.85,34323,3369,64759,14746,38739.42857,13874,54854,37692,79505,52613.42857
4/28/2023,9,Agency_9,Friday,42804,5878,Concert,0,55,48.68,68214,22826,24.57,40801,14053,26319,9021,41094.42857,13425,48682,54854,35340,54519.42857
4/29/2023,9,Agency_9,Saturday,24494,7091,Sports Event,0,55,31.59,68214,22826,32.87,42804,5878,42524,30243,38518.71429,10117.57143,31585,48682,72767,48636.28571
4/30/2023,9,Agency_9,Sunday,31161,23740,Sports Event,1,55,54.9,68214,22826,17.89,24494,7091,48906,13780,35983.71429,11540.42857,54901,31585,62686,47524.14286
5/1/2023,9,Agency_9,Monday,27743,5640,None,0,55,33.38,68214,22826,32.27,31161,23740,30850,17121,35539.85714,9900.285714,33383,54901,47971,45440.14286
5/2/2023,9,Agency_9,Tuesday,50906,12535,Concert,1,55,63.44,68214,22826,15.86,27743,5640,47453,9531,36033.14286,10329.42857,63441,33383,56984,46362.57143
5/3/2023,9,Agency_9,Wednesday,29286,7366,Sports Event,0,55,36.65,68214,22826,30.29,50906,12535,34323,3369,35313.57143,10900.42857,36652,63441,37692,46214
5/4/2023,9,Agency_9,Thursday,27672,3236,Concert,0,55,30.91,68214,22826,33.98,29286,7366,40801,14053,33438,9355.142857,30908,36652,54854,42793.14286
5/5/2023,9,Agency_9,Friday,31981,8362,Festival,0,55,40.34,68214,22826,28.24,27672,3236,42804,5878,31891.85714,9710,40343,30908,48682,41601.85714
5/6/2023,9,Agency_9,Saturday,42706,11463,Festival,0,55,54.17,68214,22826,20.71,31981,8362,24494,7091,34493.57143,10334.57143,54169,40343,31585,44828.14286
5/7/2023,9,Agency_9,Sunday,34534,7197,Sports Event,0,55,41.73,68214,22826,27.78,42706,11463,31161,23740,34975.42857,7971.285714,41731,54169,54901,42946.71429
5/8/2023,9,Agency_9,Monday,39702,15412,Concert,1,55,55.11,68214,22826,19.45,34534,7197,27743,5640,36683.85714,9367.285714,55114,41731,33383,46051.14286
5/9/2023,9,Agency_9,Tuesday,27851,12314,Sports Event,1,55,40.17,68214,22826,27.54,39702,15412,50906,12535,33390.28571,9335.714286,40165,55114,63441,42726
5/10/2023,9,Agency_9,Wednesday,41271,8479,Festival,1,55,49.75,68214,22826,23.51,27851,12314,29286,7366,35102.42857,9494.714286,49750,40165,36652,44597.14286
5/11/2023,9,Agency_9,Thursday,33267,12997,Festival,1,55,46.26,68214,22826,24.35,41271,8479,27672,3236,35901.71429,10889.14286,46264,49750,30908,46790.85714
5/12/2023,9,Agency_9,Friday,27947,13563,Sports Event,1,55,41.51,68214,22826,26.62,33267,12997,31981,8362,35325.42857,11632.14286,41510,46264,40343,46957.57143
5/13/2023,9,Agency_9,Saturday,27941,15746,Festival,0,55,43.69,68214,22826,25.09,27947,13563,42706,11463,33216.14286,12244,43687,41510,54169,45460.14286
5/14/2023,9,Agency_9,Sunday,57040,7244,Sports Event,0,55,64.28,68214,22826,16.49,27941,15746,34534,7197,36431.28571,12250.71429,64284,43687,41731,48682
5/15/2023,9,Agency_9,Monday,29472,4964,None,1,55,34.44,68214,22826,31.87,57040,7244,39702,15412,34969.85714,10758.14286,34436,64284,55114,45728
5/16/2023,9,Agency_9,Tuesday,49147,5876,Sports Event,1,55,55.02,68214,22826,21.4,29472,4964,27851,12314,38012.14286,9838.428571,55023,34436,40165,47850.57143
5/17/2023,9,Agency_9,Wednesday,33603,5531,Concert,0,55,39.13,68214,22826,29.41,49147,5876,41271,8479,36916.71429,9417.285714,39134,55023,49750,46334
5/18/2023,9,Agency_9,Thursday,18965,2937,None,0,55,21.9,68214,22826,38.55,33603,5531,33267,12997,34873.57143,7980.142857,21902,39134,46264,42853.71429
5/19/2023,9,Agency_9,Friday,24111,3326,None,0,55,27.44,68214,22826,35.7,18965,2937,27947,13563,34325.57143,6517.714286,27437,21902,41510,40843.28571
5/20/2023,9,Agency_9,Saturday,40966,9527,Sports Event,0,55,50.49,68214,22826,22.93,24111,3326,27941,15746,36186.28571,5629.285714,50493,27437,43687,41815.57143
5/21/2023,9,Agency_9,Sunday,45459,16382,Concert,1,55,61.84,68214,22826,15.89,40966,9527,57040,7244,34531.85714,6934.714286,61841,50493,64284,41466.57143
5/22/2023,9,Agency_9,Monday,24285,9214,Festival,0,55,33.5,68214,22826,31.49,45459,16382,29472,4964,33790.85714,7541.857143,33499,61841,34436,41332.71429
5/23/2023,9,Agency_9,Tuesday,41476,5853,Festival,0,55,47.33,68214,22826,25.25,24285,9214,49147,5876,32695,7538.571429,47329,33499,55023,40233.57143
5/24/2023,9,Agency_9,Wednesday,33616,11194,None,1,55,44.81,68214,22826,25.44,41476,5853,33603,5531,32696.85714,8347.571429,44810,47329,39134,41044.42857
5/25/2023,9,Agency_9,Thursday,23878,3551,Sports Event,0,55,27.43,68214,22826,35.66,33616,11194,18965,2937,33398.71429,8435.285714,27429,44810,21902,41834
5/26/2023,9,Agency_9,Friday,41942,9293,Festival,1,55,51.24,68214,22826,22.61,23878,3551,24111,3326,35946,9287.714286,51235,27429,27437,45233.71429
5/27/2023,9,Agency_9,Saturday,68662,15683,Sports Event,1,55,84.35,68214,22826,4.78,41942,9293,40966,9527,39902.57143,10167.14286,84345,51235,50493,50069.71429
5/28/2023,9,Agency_9,Sunday,28780,5978,Festival,0,55,34.76,68214,22826,31.51,68662,15683,45459,16382,37519.85714,8680.857143,34758,84345,61841,46200.71429
5/29/2023,9,Agency_9,Monday,33083,5399,None,1,55,38.48,68214,22826,29.76,28780,5978,24285,9214,38776.71429,8135.857143,38482,34758,33499,46912.57143
5/30/2023,9,Agency_9,Tuesday,26284,9675,None,1,55,35.96,68214,22826,30.17,33083,5399,41476,5853,36606.42857,8681.857143,35959,38482,47329,45288.28571
5/31/2023,9,Agency_9,Wednesday,34277,11681,Sports Event,1,55,45.96,68214,22826,24.77,26284,9675,33616,11194,36700.85714,8751.428571,45958,35959,44810,45452.28571
6/1/2023,9,Agency_9,Thursday,38838,15151,Sports Event,1,55,53.99,68214,22826,20.06,34277,11681,23878,3551,38838,10408.57143,53989,45958,27429,49246.57143
6/2/2023,9,Agency_9,Friday,34429,7750,Sports Event,0,55,42.18,68214,22826,27.45,38838,15151,41942,9293,37764.71429,10188.14286,42179,53989,51235,47952.85714
6/3/2023,9,Agency_9,Saturday,24381,5532,None,0,55,29.91,68214,22826,34.02,34429,7750,68662,15683,31438.85714,8738,29913,42179,84345,40176.85714
6/4/2023,9,Agency_9,Sunday,22699,12188,Festival,0,55,34.89,68214,22826,30.2,24381,5532,28780,5978,30570.14286,9625.142857,34887,29913,34758,40195.28571
6/5/2023,9,Agency_9,Monday,57447,7692,Sports Event,1,55,65.14,68214,22826,15.98,22699,12188,33083,5399,34050.71429,9952.714286,65139,34887,38482,44003.42857
6/6/2023,9,Agency_9,Tuesday,31461,7754,Concert,1,55,39.22,68214,22826,28.93,57447,7692,26284,9675,34790.28571,9678.285714,39215,65139,35959,44468.57143
6/7/2023,9,Agency_9,Wednesday,46062,14032,Sports Event,1,55,60.1,68214,22826,17.23,31461,7754,34277,11681,36473.85714,10014.14286,60094,39215,45958,46488
6/8/2023,9,Agency_9,Thursday,24969,4428,None,1,55,29.4,68214,22826,34.5,46062,14032,38838,15151,34492.57143,8482.285714,29397,60094,53989,42974.85714
6/9/2023,9,Agency_9,Friday,39898,4450,Sports Event,1,55,44.35,68214,22826,27.02,24969,4428,34429,7750,35273.85714,8010.857143,44348,29397,42179,43284.71429
6/10/2023,9,Agency_9,Saturday,37290,14902,Concert,0,55,52.19,68214,22826,21.01,39898,4450,24381,5532,37118,9349.428571,52192,44348,29913,46467.42857
6/11/2023,9,Agency_9,Sunday,32160,5983,Sports Event,1,55,38.14,68214,22826,29.82,37290,14902,22699,12188,38469.57143,8463,38143,52192,34887,46932.57143
6/12/2023,9,Agency_9,Monday,54399,8986,Sports Event,1,55,63.39,68214,22826,16.59,32160,5983,57447,7692,38034.14286,8647.857143,63385,38143,65139,46682
6/13/2023,9,Agency_9,Tuesday,50074,11166,Festival,1,55,61.24,68214,22826,17.23,54399,8986,31461,7754,40693.14286,9135.285714,61240,63385,39215,49828.42857
6/14/2023,9,Agency_9,Wednesday,28785,9989,Festival,0,55,38.77,68214,22826,28.7,50074,11166,46062,14032,38225,8557.714286,38774,61240,60094,46782.71429
6/15/2023,9,Agency_9,Thursday,15580,5264,None,0,55,20.84,68214,22826,38.61,28785,9989,24969,4428,36883.71429,8677.142857,20844,38774,29397,45560.85714
6/16/2023,9,Agency_9,Friday,35279,5614,Concert,1,55,40.89,68214,22826,28.52,15580,5264,39898,4450,36223.85714,8843.428571,40893,20844,44348,45067.28571
6/17/2023,9,Agency_9,Saturday,39036,9885,Festival,0,55,48.92,68214,22826,23.65,35279,5614,37290,14902,36473.28571,8126.714286,48921,40893,52192,44600
6/18/2023,9,Agency_9,Sunday,44960,7979,Festival,1,55,52.94,68214,22826,22.02,39036,9885,32160,5983,38301.85714,8411.857143,52939,48921,38143,46713.71429
6/19/2023,9,Agency_9,Monday,36344,9454,None,1,55,45.8,68214,22826,25.3,44960,7979,54399,8986,35722.57143,8478.714286,45798,52939,63385,44201.28571
6/20/2023,9,Agency_9,Tuesday,48399,10445,Festival,1,55,58.84,68214,22826,18.57,36344,9454,50074,11166,35483.28571,8375.714286,58844,45798,61240,43859
6/21/2023,9,Agency_9,Wednesday,22140,21193,Sports Event,1,55,43.33,68214,22826,24.18,48399,10445,28785,9989,34534,9976.285714,43333,58844,38774,44510.28571
6/22/2023,9,Agency_9,Thursday,19694,3502,None,0,55,23.2,68214,22826,37.79,22140,21193,15580,5264,35121.71429,9724.571429,23196,43333,20844,44846.28571
6/23/2023,9,Agency_9,Friday,33126,12467,Concert,0,55,45.59,68214,22826,24.79,19694,3502,35279,5614,34814.14286,10703.57143,45593,23196,40893,45517.71429
6/24/2023,9,Agency_9,Saturday,35791,16700,Festival,0,55,52.49,68214,22826,20.5,33126,12467,39036,9885,34350.57143,11677.14286,52491,45593,48921,46027.71429
6/25/2023,9,Agency_9,Sunday,39645,5181,None,1,55,44.83,68214,22826,26.64,35791,16700,44960,7979,33591.28571,11277.42857,44826,52491,52939,44868.71429
6/26/2023,9,Agency_9,Monday,21620,9681,None,1,55,31.3,68214,22826,32.5,39645,5181,36344,9454,31487.85714,11309.85714,31301,44826,45798,42797.71429
6/27/2023,9,Agency_9,Tuesday,9654,7991,Concert,0,55,17.65,68214,22826,39.66,21620,9681,48399,10445,25952.85714,10959.28571,17645,31301,58844,36912.14286
6/28/2023,9,Agency_9,Wednesday,19267,6878,Festival,0,55,26.15,68214,22826,35.64,9654,7991,22140,21193,25542.42857,8914.285714,26145,17645,43333,34456.71429
6/29/2023,9,Agency_9,Thursday,36084,10193,Sports Event,1,55,46.28,68214,22826,24.91,19267,6878,19694,3502,27883.85714,9870.142857,46277,26145,23196,37754
6/30/2023,9,Agency_9,Friday,33614,6675,Sports Event,1,55,40.29,68214,22826,28.61,36084,10193,33126,12467,27953.57143,9042.714286,40289,46277,45593,36996.28571
7/1/2023,9,Agency_9,Saturday,49076,15895,None,1,55,64.97,68214,22826,14.42,33614,6675,35791,16700,29851.42857,8927.714286,64971,40289,52491,38779.14286
7/2/2023,9,Agency_9,Sunday,22134,14858,None,1,55,36.99,68214,22826,28.62,49076,15895,39645,5181,27349.85714,10310.14286,36992,64971,44826,37660
7/3/2023,9,Agency_9,Monday,35103,12514,Sports Event,1,55,47.62,68214,22826,23.77,22134,14858,21620,9681,29276,10714.85714,47617,36992,31301,39990.85714
7/4/2023,9,Agency_9,Tuesday,29524,6256,Festival,0,55,35.78,68214,22826,30.94,35103,12514,9654,7991,32114.57143,10467,35780,47617,17645,42581.57143
7/5/2023,9,Agency_9,Wednesday,37378,8926,Sports Event,0,55,46.31,68214,22826,25.15,29524,6256,19267,6878,34701.85714,10759.57143,46304,35780,26145,45461.42857
7/6/2023,9,Agency_9,Thursday,34353,5688,Concert,1,55,40.04,68214,22826,28.93,37378,8926,36084,10193,34454.57143,10116,40041,46304,46277,44570.57143
7/7/2023,9,Agency_9,Friday,30287,4086,Sports Event,1,55,34.37,68214,22826,32.08,34353,5688,33614,6675,33979.28571,9746.142857,34373,40041,40289,43725.42857
7/8/2023,9,Agency_9,Saturday,46942,8062,Concert,1,55,55.01,68214,22826,20.97,30287,4086,49076,15895,33674.42857,8627.142857,55004,34373,64971,42301.57143
7/9/2023,9,Agency_9,Sunday,43692,23947,Festival,1,55,67.64,68214,22826,11.48,46942,8062,22134,14858,36754.14286,9925.571429,67639,55004,36992,46679.71429
7/10/2023,9,Agency_9,Monday,50692,11745,Concert,1,55,62.44,68214,22826,16.52,43692,23947,35103,12514,38981.14286,9815.714286,62437,67639,47617,48796.85714
7/11/2023,9,Agency_9,Tuesday,19564,8759,None,0,55,28.32,68214,22826,34.17,50692,11745,29524,6256,37558.28571,10173.28571,28323,62437,35780,47731.57143
7/12/2023,9,Agency_9,Wednesday,44075,10338,Festival,1,55,54.41,68214,22826,20.81,19564,8759,37378,8926,38515,10375,54413,28323,46304,48890
7/13/2023,9,Agency_9,Thursday,16729,8101,None,1,55,24.83,68214,22826,36.05,44075,10338,34353,5688,35997.28571,10719.71429,24830,54413,40041,46717
7/14/2023,9,Agency_9,Friday,36219,6351,Sports Event,0,55,42.57,68214,22826,27.53,16729,8101,30287,4086,36844.71429,11043.28571,42570,24830,34373,47888
7/15/2023,9,Agency_9,Saturday,25747,5553,None,0,55,31.3,68214,22826,33.32,36219,6351,46942,8062,33816.85714,10684.85714,31300,42570,55004,44501.71429
7/16/2023,9,Agency_9,Sunday,44644,74,Festival,1,55,44.72,68214,22826,27.71,25747,5553,43692,23947,33952.85714,7274.428571,44718,31300,67639,41227.28571
7/17/2023,9,Agency_9,Monday,24558,9713,None,1,55,34.27,68214,22826,31.01,44644,74,50692,11745,30219.42857,6984.142857,34271,44718,62437,37203.57143
7/18/2023,9,Agency_9,Tuesday,25263,8678,Sports Event,0,55,33.94,68214,22826,31.38,24558,9713,19564,8759,31033.57143,6972.571429,33941,34271,28323,38006.14286
7/19/2023,9,Agency_9,Wednesday,24330,9724,Festival,0,55,34.05,68214,22826,31.11,25263,8678,44075,10338,28212.85714,6884.857143,34054,33941,54413,35097.71429
7/20/2023,9,Agency_9,Thursday,36888,7427,Festival,1,55,44.32,68214,22826,26.44,24330,9724,16729,8101,31092.71429,6788.571429,44315,34054,24830,37881.28571
7/21/2023,9,Agency_9,Friday,51990,16319,Sports Event,1,55,68.31,68214,22826,12.67,36888,7427,36219,6351,33345.71429,8212.571429,68309,44315,42570,41558.28571
7/22/2023,9,Agency_9,Saturday,39721,18548,Concert,1,55,58.27,68214,22826,17.24,51990,16319,25747,5553,35342,10069,58269,68309,31300,45411
7/23/2023,9,Agency_9,Sunday,53087,19442,Sports Event,1,55,72.53,68214,22826,9.93,39721,18548,44644,74,36548.14286,12835.85714,72529,58269,44718,49384
7/24/2023,9,Agency_9,Monday,17292,11922,Sports Event,0,55,29.21,68214,22826,33.09,53087,19442,24558,9713,35510.14286,13151.42857,29214,72529,34271,48661.57143
7/25/2023,9,Agency_9,Tuesday,17151,4284,None,0,55,21.43,68214,22826,38.51,17292,11922,25263,8678,34351.28571,12523.71429,21435,29214,33941,46875
7/26/2023,9,Agency_9,Wednesday,49783,9525,Sports Event,0,55,59.31,68214,22826,18.53,17151,4284,24330,9724,37987.42857,12495.28571,59308,21435,34054,50482.71429
7/27/2023,9,Agency_9,Thursday,35232,1401,Sports Event,1,55,36.63,68214,22826,31.49,49783,9525,36888,7427,37750.85714,11634.42857,36633,59308,44315,49385.28571
7/28/2023,9,Agency_9,Friday,40422,3925,Sports Event,0,55,44.35,68214,22826,27.13,35232,1401,51990,16319,36098.28571,9863.857143,44347,36633,68309,45962.14286
7/29/2023,9,Agency_9,Saturday,35057,13418,Concert,1,55,48.48,68214,22826,23.16,40422,3925,39721,18548,35432,9131,48475,44347,58269,44563
7/30/2023,9,Agency_9,Sunday,48747,14466,Sports Event,0,55,63.21,68214,22826,15.58,35057,13418,53087,19442,34812,8420.142857,63213,48475,72529,43232.14286
7/31/2023,9,Agency_9,Monday,28815,9547,Concert,0,55,38.36,68214,22826,28.99,48747,14466,17292,11922,36458.14286,8080.857143,38362,63213,29214,44539
8/1/2023,9,Agency_9,Tuesday,33146,12564,Festival,1,55,45.71,68214,22826,24.72,28815,9547,17151,4284,38743.14286,9263.714286,45710,38362,21435,48006.85714
8/2/2023,9,Agency_9,Wednesday,39713,16510,Sports Event,1,55,56.22,68214,22826,18.67,33146,12564,49783,9525,37304.57143,10261.57143,56223,45710,59308,47566.14286
8/3/2023,9,Agency_9,Thursday,24835,5987,None,0,55,30.82,68214,22826,33.48,39713,16510,35232,1401,35819.28571,10916.71429,30822,56223,36633,46736
8/4/2023,9,Agency_9,Friday,35466,15429,Sports Event,1,55,50.9,68214,22826,21.55,24835,5987,40422,3925,35111.28571,12560.14286,50895,30822,44347,47671.42857
8/5/2023,9,Agency_9,Saturday,35172,6267,Festival,0,55,41.44,68214,22826,28.11,35466,15429,35057,13418,35127.71429,11538.57143,41439,50895,48475,46666.28571
8/6/2023,9,Agency_9,Sunday,32369,11423,Festival,0,55,43.79,68214,22826,25.9,35172,6267,48747,14466,32788,11103.85714,43792,41439,63213,43891.85714
8/7/2023,9,Agency_9,Monday,36826,7874,Sports Event,0,55,44.7,68214,22826,26.16,32369,11423,28815,9547,33932.42857,10864.85714,44700,43792,38362,44797.28571
8/8/2023,9,Agency_9,Tuesday,13954,5113,None,0,55,19.07,68214,22826,39.53,36826,7874,33146,12564,31190.71429,9800.428571,19067,44700,45710,40991.14286
8/9/2023,9,Agency_9,Wednesday,30850,9130,Concert,0,55,39.98,68214,22826,28.27,13954,5113,39713,16510,29924.57143,8746.142857,39980,19067,56223,38670.71429
8/10/2023,9,Agency_9,Thursday,47968,16748,Concert,1,55,64.72,68214,22826,14.38,30850,9130,24835,5987,33229.28571,10283.42857,64716,39980,30822,43512.71429
8/11/2023,9,Agency_9,Friday,33204,8965,Sports Event,1,55,42.17,68214,22826,27.21,47968,16748,35466,15429,32906.14286,9360,42169,64716,50895,42266.14286
8/12/2023,9,Agency_9,Saturday,34629,19792,Sports Event,1,55,54.42,68214,22826,18.92,33204,8965,35172,6267,32828.57143,11292.14286,54421,42169,41439,44120.71429
8/13/2023,9,Agency_9,Sunday,32692,5679,None,0,55,38.37,68214,22826,29.76,34629,19792,32369,11423,32874.71429,10471.57143,38371,54421,43792,43346.28571
8/14/2023,9,Agency_9,Monday,36644,18880,Concert,1,55,55.52,68214,22826,18.55,32692,5679,36826,7874,32848.71429,12043.85714,55524,38371,44700,44892.57143
8/15/2023,9,Agency_9,Tuesday,33790,9982,Concert,0,55,43.77,68214,22826,26.2,36644,18880,13954,5113,35682.42857,12739.42857,43772,55524,19067,48421.85714
8/16/2023,9,Agency_9,Wednesday,27387,15129,Festival,1,55,42.52,68214,22826,25.8,33790,9982,30850,9130,35187.71429,13596.42857,42516,43772,39980,48784.14286
8/17/2023,9,Agency_9,Thursday,23031,4642,Concert,0,55,27.67,68214,22826,35.32,27387,15129,47968,16748,31625.28571,11867,27673,42516,64716,43492.28571
8/18/2023,9,Agency_9,Friday,27399,6507,Sports Event,0,55,33.91,68214,22826,31.83,23031,4642,33204,8965,30796,11515.85714,33906,27673,42169,42311.85714
8/19/2023,9,Agency_9,Saturday,22670,2753,None,0,55,25.42,68214,22826,36.82,27399,6507,34629,19792,29087.57143,9081.714286,25423,33906,54421,38169.28571
8/20/2023,9,Agency_9,Sunday,58017,22446,Festival,1,55,80.46,68214,22826,5.36,22670,2753,32692,5679,32705.42857,11477,80463,25423,38371,44182.42857
8/21/2023,9,Agency_9,Monday,13341,9738,None,1,55,23.08,68214,22826,36.6,58017,22446,36644,18880,29376.42857,10171,23079,80463,55524,39547.42857
8/22/2023,9,Agency_9,Tuesday,23920,11412,Festival,0,55,35.33,68214,22826,30.14,13341,9738,33790,9982,27966.42857,10375.28571,35332,23079,43772,38341.71429
8/23/2023,9,Agency_9,Wednesday,29485,8596,Sports Event,0,55,38.08,68214,22826,29.32,23920,11412,27387,15129,28266.14286,9442,38081,35332,42516,37708.14286
8/24/2023,9,Agency_9,Thursday,28611,12620,Concert,0,55,41.23,68214,22826,26.95,29485,8596,23031,4642,29063.28571,10581.71429,41231,38081,27673,39645
8/25/2023,9,Agency_9,Friday,17942,8701,None,1,55,26.64,68214,22826,35.02,28611,12620,27399,6507,27712.28571,10895.14286,26643,41231,33906,38607.42857
8/26/2023,9,Agency_9,Saturday,45910,14214,Sports Event,0,55,60.13,68214,22826,17.18,17942,8701,22670,2753,31032.28571,12532.42857,60124,26643,25423,43564.71429
8/27/2023,9,Agency_9,Sunday,56921,8711,Concert,0,55,65.63,68214,22826,15.53,45910,14214,58017,22446,30875.71429,10570.28571,65632,60124,80463,41446
8/28/2023,9,Agency_9,Monday,48332,11393,Festival,1,55,59.73,68214,22826,17.94,56921,8711,13341,9738,35874.42857,10806.71429,59725,65632,23079,46681.14286
8/29/2023,9,Agency_9,Tuesday,39250,8472,Sports Event,0,55,47.72,68214,22826,24.53,48332,11393,23920,11412,38064.42857,10386.71429,47722,59725,35332,48451.14286
8/30/2023,9,Agency_9,Wednesday,27090,12940,Sports Event,0,55,40.03,68214,22826,27.48,39250,8472,29485,8596,37722.28571,11007.28571,40030,47722,38081,48729.57143
8/31/2023,9,Agency_9,Thursday,26313,3695,Concert,0,55,30.01,68214,22826,34.34,27090,12940,28611,12620,37394,9732.285714,30008,40030,41231,47126.28571
9/1/2023,9,Agency_9,Friday,26122,10604,Concert,0,55,36.73,68214,22826,29.6,26313,3695,17942,8701,38562.57143,10004.14286,36726,30008,26643,48566.71429
9/2/2023,9,Agency_9,Saturday,63086,16156,Festival,1,55,79.24,68214,22826,7.23,26122,10604,45910,14214,41016.28571,10281.57143,79242,36726,60124,51297.85714
9/3/2023,9,Agency_9,Sunday,62220,7063,Sports Event,1,55,69.28,68214,22826,14.03,63086,16156,56921,8711,41773.28571,10046.14286,69283,79242,65632,51819.42857
9/4/2023,9,Agency_9,Monday,23117,6190,None,1,55,29.31,68214,22826,34.19,62220,7063,48332,11393,38171.14286,9302.857143,29307,69283,59725,47474
9/5/2023,9,Agency_9,Tuesday,29140,8785,Festival,0,55,37.93,68214,22826,29.37,23117,6190,39250,8472,36726.85714,9347.571429,37925,29307,47722,46074.42857
9/6/2023,9,Agency_9,Wednesday,45735,9781,Festival,1,55,55.52,68214,22826,20.37,29140,8785,27090,12940,39390.42857,8896.285714,55516,37925,40030,48286.71429
9/7/2023,9,Agency_9,Thursday,31042,8345,Sports Event,0,55,39.39,68214,22826,28.72,45735,9781,26313,3695,40066,9560.571429,39387,55516,30008,49626.57143
9/8/2023,9,Agency_9,Friday,23055,8112,Festival,0,55,31.17,68214,22826,32.88,31042,8345,26122,10604,39627.85714,9204.571429,31167,39387,36726,48832.42857
9/9/2023,9,Agency_9,Saturday,45117,14445,Festival,1,55,59.56,68214,22826,17.41,23055,8112,63086,16156,37060.85714,8960.142857,59562,31167,79242,46021
9/10/2023,9,Agency_9,Sunday,47169,15937,Festival,1,55,63.11,68214,22826,15.34,45117,14445,62220,7063,34910.71429,10227.85714,63106,59562,69283,45138.57143
9/11/2023,9,Agency_9,Monday,17838,7545,None,0,55,25.38,68214,22826,35.88,47169,15937,23117,6190,34156.57143,10421.42857,25383,63106,29307,44578
9/12/2023,9,Agency_9,Tuesday,14152,3558,None,0,55,17.71,68214,22826,40.52,17838,7545,29140,8785,32015.42857,9674.714286,17710,25383,37925,41690.14286
9/13/2023,9,Agency_9,Wednesday,66103,6959,Festival,1,55,73.06,68214,22826,12.16,14152,3558,45735,9781,34925.14286,9271.571429,73062,17710,55516,44196.71429
9/14/2023,9,Agency_9,Thursday,25800,15393,Festival,1,55,41.19,68214,22826,26.41,66103,6959,31042,8345,34176.28571,10278.42857,41193,73062,39387,44454.71429
9/15/2023,9,Agency_9,Friday,9614,4529,None,0,55,14.14,68214,22826,42.11,25800,15393,23055,8112,32256.14286,9766.571429,14143,41193,31167,42022.71429
9/16/2023,9,Agency_9,Saturday,71905,5909,Sports Event,1,55,77.82,68214,22826,10,9614,4529,45117,14445,36083,8547.142857,77814,14143,59562,44630.14286
9/17/2023,9,Agency_9,Sunday,15740,3641,None,1,55,19.38,68214,22826,39.67,71905,5909,47169,15937,31593.14286,6790.571429,19381,77814,63106,38383.71429
9/18/2023,9,Agency_9,Monday,47757,17252,Festival,1,55,65.01,68214,22826,14.13,15740,3641,17838,7545,35867.28571,8177.285714,65009,19381,25383,44044.57143
9/19/2023,9,Agency_9,Tuesday,17437,6366,None,0,55,23.8,68214,22826,36.91,47757,17252,14152,3558,36336.57143,8578.428571,23803,65009,17710,44915
9/20/2023,9,Agency_9,Wednesday,40426,14575,Festival,0,55,55,68214,22826,19.67,17437,6366,66103,6959,32668.42857,9666.428571,55001,23803,73062,42334.85714
9/21/2023,9,Agency_9,Thursday,36597,944,Concert,1,55,37.54,68214,22826,31.12,40426,14575,25800,15393,34210.85714,7602.285714,37541,55001,41193,41813.14286
9/22/2023,9,Agency_9,Friday,30995,9867,Festival,1,55,40.86,68214,22826,27.68,36597,944,9614,4529,37265.28571,8364.857143,40862,37541,14143,45630.14286
9/23/2023,9,Agency_9,Saturday,29179,8415,None,1,55,37.6,68214,22826,29.6,30995,9867,71905,5909,31161.57143,8722.857143,37594,40862,77814,39884.42857
9/24/2023,9,Agency_9,Sunday,39926,13737,None,1,55,53.66,68214,22826,20.51,29179,8415,15740,3641,34616.71429,10165.14286,53663,37594,19381,44781.85714
9/25/2023,9,Agency_9,Monday,37324,17126,Sports Event,1,55,54.45,68214,22826,19.43,39926,13737,47757,17252,33126.28571,10147.14286,54450,53663,65009,43273.42857
9/26/2023,9,Agency_9,Tuesday,42486,12207,Festival,1,55,54.69,68214,22826,20.3,37324,17126,17437,6366,36704.71429,10981.57143,54693,54450,23803,47686.28571
9/27/2023,9,Agency_9,Wednesday,24532,5144,None,0,55,29.68,68214,22826,34.22,42486,12207,40426,14575,34434.14286,9634.285714,29676,54693,55001,44068.42857
9/28/2023,9,Agency_9,Thursday,45433,3609,Festival,0,55,49.04,68214,22826,24.84,24532,5144,36597,944,35696.42857,10015,49042,29676,37541,45711.42857
9/29/2023,9,Agency_9,Friday,33976,11295,Festival,1,55,45.27,68214,22826,25.19,45433,3609,30995,9867,36122.28571,10219,45271,49042,40862,46341.28571
9/30/2023,9,Agency_9,Saturday,51940,23313,Festival,1,55,75.25,68214,22826,7.8,33976,11295,29179,8415,39373.85714,12347.28571,75253,45271,37594,51721.14286
10/1/2023,9,Agency_9,Sunday,23853,2801,None,0,55,26.66,68214,22826,36.2,51940,23313,39926,13737,37077.71429,10785,26654,75253,53663,47862.71429
10/2/2023,9,Agency_9,Monday,47213,15491,Concert,1,55,62.7,68214,22826,15.63,23853,2801,37324,17126,38490.42857,10551.42857,62704,26654,54450,49041.85714
10/3/2023,9,Agency_9,Tuesday,15435,8486,Concert,0,55,23.92,68214,22826,36.43,47213,15491,42486,12207,34626,10019.85714,23921,62704,54693,44645.85714
10/4/2023,9,Agency_9,Wednesday,18073,6239,Sports Event,0,55,24.31,68214,22826,36.68,15435,8486,24532,5144,33703.28571,10176.28571,24312,23921,29676,43879.57143
10/5/2023,9,Agency_9,Thursday,30195,15750,Festival,1,55,45.95,68214,22826,23.96,18073,6239,45433,3609,31526.42857,11910.71429,45945,24312,49042,43437.14286
10/6/2023,9,Agency_9,Friday,20584,2428,None,0,55,23.01,68214,22826,38.09,30195,15750,33976,11295,29613.28571,10644,23012,45945,45271,40257.28571
10/7/2023,9,Agency_9,Saturday,43920,4711,Concert,0,55,48.63,68214,22826,24.83,20584,2428,51940,23313,28467.57143,7986.571429,48631,23012,75253,36454.14286
10/8/2023,9,Agency_9,Sunday,50661,10429,Concert,1,55,61.09,68214,22826,17.45,43920,4711,23853,2801,32297.28571,9076.285714,61090,48631,26654,41373.57143
10/9/2023,9,Agency_9,Monday,35433,14299,Festival,1,55,49.73,68214,22826,22.36,50661,10429,47213,15491,30614.42857,8906,49732,61090,62704,39520.42857
10/10/2023,9,Agency_9,Tuesday,33910,13044,Sports Event,0,55,46.95,68214,22826,24,35433,14299,15435,8486,33253.71429,9557.142857,46954,49732,23921,42810.85714
10/11/2023,9,Agency_9,Wednesday,29382,9540,Festival,0,55,38.92,68214,22826,28.72,33910,13044,18073,6239,34869.28571,10028.71429,38922,46954,24312,44898
10/12/2023,9,Agency_9,Thursday,34731,12763,Festival,1,55,47.5,68214,22826,23.78,29382,9540,30195,15750,35517.28571,9602,47494,38922,45945,45119.28571
10/13/2023,9,Agency_9,Friday,33295,8165,Concert,0,55,41.46,68214,22826,27.72,34731,12763,20584,2428,37333.14286,10421.57143,41460,47494,23012,47754.71429
10/14/2023,9,Agency_9,Saturday,25695,17518,Sports Event,1,55,43.21,68214,22826,24.97,33295,8165,43920,4711,34729.57143,12251.14286,43213,41460,48631,46980.71429
10/15/2023,9,Agency_9,Sunday,51063,11259,Concert,1,55,62.32,68214,22826,16.67,25695,17518,50661,10429,34787,12369.71429,62322,43213,61090,47156.71429
10/16/2023,9,Agency_9,Monday,20367,13516,Sports Event,0,55,33.88,68214,22826,30.44,51063,11259,35433,14299,32634.71429,12257.85714,33883,62322,49732,44892.57143
10/17/2023,9,Agency_9,Tuesday,22457,4541,None,0,55,27,68214,22826,35.68,20367,13516,33910,13044,30998.57143,11043.14286,26998,33883,46954,42041.71429
10/18/2023,9,Agency_9,Wednesday,21471,5705,Concert,0,55,27.18,68214,22826,35.36,22457,4541,29382,9540,29868.42857,10495.28571,27176,26998,38922,40363.71429
10/19/2023,9,Agency_9,Thursday,39768,8967,Sports Event,0,55,48.74,68214,22826,23.92,21471,5705,34731,12763,30588,9953,48735,27176,47494,40541
10/20/2023,9,Agency_9,Friday,25870,10232,Festival,0,55,36.1,68214,22826,29.99,39768,8967,33295,8165,29527.28571,10248.28571,36102,48735,41460,39775.57143
10/21/2023,9,Agency_9,Saturday,24847,14561,None,1,55,39.41,68214,22826,27.47,25870,10232,25695,17518,29406.14286,9825.857143,39408,36102,43213,39232
10/22/2023,9,Agency_9,Sunday,62627,12580,Sports Event,1,55,75.21,68214,22826,9.97,24847,14561,51063,11259,31058.14286,10014.57143,75207,39408,62322,41072.71429
10/23/2023,9,Agency_9,Monday,25284,0,Concert,0,55,25.28,68214,22826,37.44,62627,12580,20367,13516,31760.57143,8083.714286,25284,75207,33883,39844.28571
10/24/2023,9,Agency_9,Tuesday,18888,3945,Festival,0,55,22.83,68214,22826,37.88,25284,0,22457,4541,31250.71429,7998.571429,22833,25284,26998,39249.28571
10/25/2023,9,Agency_9,Wednesday,20675,4347,None,0,55,25.02,68214,22826,36.7,18888,3945,21471,5705,31137,7804.571429,25022,22833,27176,38941.57143
10/26/2023,9,Agency_9,Thursday,25882,10560,Sports Event,1,55,36.44,68214,22826,29.75,20675,4347,39768,8967,29153.28571,8032.142857,36442,25022,48735,37185.42857
10/27/2023,9,Agency_9,Friday,33789,10293,Sports Event,0,55,44.08,68214,22826,25.99,25882,10560,25870,10232,30284.57143,8040.857143,44082,36442,36102,38325.42857
10/28/2023,9,Agency_9,Saturday,18901,10482,Concert,0,55,29.38,68214,22826,33.3,33789,10293,24847,14561,29435.14286,7458.142857,29383,44082,39408,36893.28571
10/29/2023,9,Agency_9,Sunday,30614,21048,Concert,1,55,51.66,68214,22826,20.04,18901,10482,62627,12580,24861.85714,8667.857143,51662,29383,75207,33529.71429
10/30/2023,9,Agency_9,Monday,46644,7623,Festival,1,55,54.27,68214,22826,21.43,30614,21048,25284,0,27913.28571,9756.857143,54267,51662,25284,37670.14286
10/31/2023,9,Agency_9,Tuesday,24253,6930,Sports Event,0,55,31.18,68214,22826,33.11,46644,7623,18888,3945,28679.71429,10183.28571,31183,54267,22833,38863
11/1/2023,9,Agency_9,Wednesday,13104,9640,Sports Event,0,55,22.74,68214,22826,36.78,24253,6930,20675,4347,27598.14286,10939.42857,22744,31183,25022,38537.57143
11/2/2023,9,Agency_9,Thursday,36338,16517,Concert,1,55,52.86,68214,22826,20.35,13104,9640,25882,10560,29091.85714,11790.42857,52855,22744,36442,40882.28571
11/3/2023,9,Agency_9,Friday,28288,8951,Concert,1,55,37.24,68214,22826,29.68,36338,16517,33789,10293,28306,11598.71429,37239,52855,44082,39904.71429
11/4/2023,9,Agency_9,Saturday,29172,9254,Concert,1,55,38.43,68214,22826,29.02,28288,8951,18901,10482,29773.28571,11423.28571,38426,37239,29383,41196.57143
11/5/2023,9,Agency_9,Sunday,25362,15450,Concert,0,55,40.81,68214,22826,26.59,29172,9254,30614,21048,29023,10623.57143,40812,38426,51662,39646.57143
11/6/2023,9,Agency_9,Monday,32190,12490,Festival,1,55,44.68,68214,22826,25.25,25362,15450,46644,7623,26958.14286,11318.85714,44680,40812,54267,38277
11/7/2023,9,Agency_9,Tuesday,35287,5857,Concert,1,55,41.14,68214,22826,28.34,32190,12490,24253,6930,28534.42857,11165.57143,41144,44680,31183,39700
11/8/2023,9,Agency_9,Wednesday,37358,14751,Concert,1,55,52.11,68214,22826,21.08,35287,5857,13104,9640,31999.28571,11895.71429,52109,41144,22744,43895
11/9/2023,9,Agency_9,Thursday,20941,11250,Sports Event,0,55,32.19,68214,22826,31.74,37358,14751,36338,16517,29799.71429,11143.28571,32191,52109,52855,40943
11/10/2023,9,Agency_9,Friday,20476,5647,None,1,55,26.12,68214,22826,35.89,20941,11250,28288,8951,28683.71429,10671.28571,26123,32191,37239,39355
11/11/2023,9,Agency_9,Saturday,53008,11364,Concert,1,55,64.37,68214,22826,15.63,20476,5647,29172,9254,32088.85714,10972.71429,64372,26123,38426,43061.57143
11/12/2023,9,Agency_9,Sunday,36336,9657,Sports Event,0,55,45.99,68214,22826,25.16,53008,11364,25362,15450,33656.57143,10145.14286,45993,64372,40812,43801.71429
11/13/2023,9,Agency_9,Monday,40259,566,Sports Event,1,55,40.83,68214,22826,29.56,36336,9657,32190,12490,34809.28571,8441.714286,40825,45993,44680,43251
11/14/2023,9,Agency_9,Tuesday,16276,10592,Festival,0,55,26.87,68214,22826,34.53,40259,566,35287,5857,32093.42857,9118.142857,26868,40825,41144,41211.57143
11/15/2023,9,Agency_9,Wednesday,25185,3179,None,0,55,28.36,68214,22826,35.27,16276,10592,37358,14751,30354.42857,7465,28364,26868,52109,37819.42857
11/16/2023,9,Agency_9,Thursday,24412,7824,None,1,55,32.24,68214,22826,32.4,25185,3179,20941,11250,30850.28571,6975.571429,32236,28364,32191,37825.85714
11/17/2023,9,Agency_9,Friday,45758,2246,Concert,1,55,48.01,68214,22826,25.63,24412,7824,20476,5647,34462,6489.714286,48004,32236,26123,40951.71429
11/18/2023,9,Agency_9,Saturday,28024,9578,Festival,0,55,37.6,68214,22826,29.37,45758,2246,53008,11364,30892.85714,6234.571429,37602,48004,64372,37127.42857
11/19/2023,9,Agency_9,Sunday,36683,18192,None,1,55,54.88,68214,22826,19.01,28024,9578,36336,9657,30942.42857,7453.857143,54875,37602,45993,38396.28571
11/20/2023,9,Agency_9,Monday,36775,5202,Sports Event,1,55,41.98,68214,22826,28.06,36683,18192,40259,566,30444.71429,8116.142857,41977,54875,40825,38560.85714
11/21/2023,9,Agency_9,Tuesday,42921,18185,Sports Event,1,55,61.11,68214,22826,15.89,36775,5202,16276,10592,34251.14286,9200.857143,61106,41977,26868,43452
11/22/2023,9,Agency_9,Wednesday,30810,5416,Concert,0,55,36.23,68214,22826,30.89,42921,18185,25185,3179,35054.71429,9520.428571,36226,61106,28364,44575.14286
11/23/2023,9,Agency_9,Thursday,48338,15058,Concert,1,55,63.4,68214,22826,15.38,30810,5416,24412,7824,38472.71429,10553.85714,63396,36226,32236,49026.57143
11/24/2023,9,Agency_9,Friday,28994,13713,Concert,1,55,42.71,68214,22826,25.99,48338,15058,45758,2246,36077.85714,12192,42707,63396,48004,48269.85714
11/25/2023,9,Agency_9,Saturday,58467,22781,Festival,1,55,81.25,68214,22826,4.9,28994,13713,28024,9578,40426.85714,14078.14286,81248,42707,37602,54505
11/26/2023,9,Agency_9,Sunday,35400,9465,Concert,0,55,44.87,68214,22826,25.76,58467,22781,36683,18192,40243.57143,12831.42857,44865,81248,54875,53075
11/27/2023,9,Agency_9,Monday,50965,6138,Festival,1,55,57.1,68214,22826,20.31,35400,9465,36775,5202,42270.71429,12965.14286,57103,44865,41977,55235.85714
11/28/2023,9,Agency_9,Tuesday,43274,5376,Concert,1,55,48.65,68214,22826,24.68,50965,6138,42921,18185,42321.14286,11135.28571,48650,57103,61106,53456.42857
11/29/2023,9,Agency_9,Wednesday,32923,6276,None,1,55,39.2,68214,22826,29.23,43274,5376,30810,5416,42623,11258.14286,39199,48650,36226,53881.14286
11/30/2023,9,Agency_9,Thursday,26342,5982,None,0,55,32.32,68214,22826,32.73,32923,6276,48338,15058,39480.71429,9961.571429,32324,39199,63396,49442.28571
12/1/2023,9,Agency_9,Friday,27071,18680,Sports Event,1,55,45.75,68214,22826,23.47,26342,5982,28994,13713,39206,10671.14286,45751,32324,42707,49877.14286
12/2/2023,9,Agency_9,Saturday,64949,20927,Festival,1,55,85.88,68214,22826,2.96,27071,18680,58467,22781,40132,10406.28571,85876,45751,81248,50538.28571
12/3/2023,9,Agency_9,Sunday,37889,13573,Festival,1,55,51.46,68214,22826,21.64,64949,20927,35400,9465,40487.57143,10993.14286,51462,85876,44865,51480.71429
12/4/2023,9,Agency_9,Monday,40417,8548,Festival,1,55,48.97,68214,22826,23.89,37889,13573,50965,6138,38980.71429,11337.42857,48965,51462,57103,50318.14286
12/5/2023,9,Agency_9,Tuesday,42691,8989,Sports Event,0,55,51.68,68214,22826,22.45,40417,8548,43274,5376,38897.42857,11853.57143,51680,48965,48650,50751
12/6/2023,9,Agency_9,Wednesday,12641,13513,Festival,1,55,26.16,68214,22826,34.3,42691,8989,32923,6276,36000,12887.42857,26154,51680,39199,48887.42857
12/7/2023,9,Agency_9,Thursday,35605,11543,Concert,1,55,47.15,68214,22826,24.2,12641,13513,26342,5982,37323.28571,13681.85714,47148,26154,32324,51005.14286
12/8/2023,9,Agency_9,Friday,18156,6614,None,0,55,24.77,68214,22826,36.38,35605,11543,27071,18680,36049.71429,11958.14286,24770,47148,45751,48007.85714
12/9/2023,9,Agency_9,Saturday,46076,12300,Concert,0,55,58.38,68214,22826,18.44,18156,6614,64949,20927,33353.57143,10725.71429,58376,24770,85876,44079.28571
12/10/2023,9,Agency_9,Sunday,32945,10866,Concert,0,55,43.81,68214,22826,26.01,46076,12300,37889,13573,32647.28571,10339,43811,58376,51462,42986.28571
12/11/2023,9,Agency_9,Monday,26126,4753,None,1,55,30.88,68214,22826,33.7,32945,10866,40417,8548,30605.71429,9796.857143,30879,43811,48965,40402.57143
12/12/2023,9,Agency_9,Tuesday,34341,10064,Festival,0,55,44.41,68214,22826,25.87,26126,4753,42691,8989,29412.85714,9950.428571,44405,30879,51680,39363.28571
12/13/2023,9,Agency_9,Wednesday,54018,17873,Sports Event,1,55,71.89,68214,22826,10.56,34341,10064,12641,13513,35323.85714,10573.28571,71891,44405,26154,45897.14286
12/14/2023,9,Agency_9,Thursday,21542,9296,None,1,55,30.84,68214,22826,32.81,54018,17873,35605,11543,33314.85714,10252.28571,30838,71891,47148,43567.14286
12/15/2023,9,Agency_9,Friday,19818,8947,None,1,55,28.77,68214,22826,33.91,21542,9296,18156,6614,33552.28571,10585.57143,28765,30838,24770,44137.85714
12/16/2023,9,Agency_9,Saturday,40753,9136,Festival,1,55,49.89,68214,22826,23.31,19818,8947,46076,12300,32791.85714,10133.57143,49889,28765,58376,42925.42857
12/17/2023,9,Agency_9,Sunday,50076,0,Sports Event,1,55,50.08,68214,22826,25.05,40753,9136,32945,10866,35239.14286,8581.285714,50076,49889,43811,43820.42857
12/18/2023,9,Agency_9,Monday,11245,4645,None,0,55,15.89,68214,22826,41.21,50076,0,26126,4753,33113.28571,8565.857143,15890,50076,30879,41679.14286
12/19/2023,9,Agency_9,Tuesday,26535,5965,None,1,55,32.5,68214,22826,32.64,11245,4645,34341,10064,31998.14286,7980.285714,32500,15890,44405,39978.42857
12/20/2023,9,Agency_9,Wednesday,12102,3364,None,0,55,15.47,68214,22826,41.68,26535,5965,54018,17873,26010.14286,5907.571429,15466,32500,71891,31917.71429
12/21/2023,9,Agency_9,Thursday,32934,10477,Festival,0,55,43.41,68214,22826,26.28,12102,3364,21542,9296,27637.57143,6076.285714,43411,15466,30838,33713.85714
12/22/2023,9,Agency_9,Friday,38840,17404,Concert,1,55,56.25,68214,22826,18.48,32934,10477,19818,8947,30355,7284.428571,56244,43411,28765,37639.42857
12/23/2023,9,Agency_9,Saturday,39574,7746,Concert,0,55,47.32,68214,22826,24.88,38840,17404,40753,9136,30186.57143,7085.857143,47320,56244,49889,37272.42857
12/24/2023,9,Agency_9,Sunday,43516,6788,Concert,1,55,50.31,68214,22826,23.57,39574,7746,50076,0,29249.42857,8055.571429,50304,47320,50076,37305
12/25/2023,9,Agency_9,Monday,19459,7224,None,0,55,26.68,68214,22826,35.3,43516,6788,11245,4645,30422.85714,8424,26683,50304,15890,38846.85714
12/26/2023,9,Agency_9,Tuesday,35139,13266,Sports Event,0,55,48.41,68214,22826,23.23,19459,7224,26535,5965,31652,9467,48405,26683,32500,41119
12/27/2023,9,Agency_9,Wednesday,27727,13076,Festival,0,55,40.8,68214,22826,27.07,35139,13266,12102,3364,33884.14286,10854.42857,40803,48405,15466,44738.57143
12/28/2023,9,Agency_9,Thursday,28549,13503,Festival,0,55,42.05,68214,22826,26.36,27727,13076,32934,10477,33257.71429,11286.71429,42052,40803,43411,44544.42857
12/29/2023,9,Agency_9,Friday,38785,15265,Sports Event,1,55,54.05,68214,22826,20.01,28549,13503,38840,17404,33249.85714,10981.14286,54050,42052,56244,44231
12/30/2023,9,Agency_9,Saturday,42705,8395,None,1,55,51.1,68214,22826,22.86,38785,15265,39574,7746,33697.14286,11073.85714,51100,54050,47320,44771
12/31/2023,9,Agency_9,Sunday,37963,16745,Concert,0,55,54.71,68214,22826,19.38,42705,8395,43516,6788,32903.85714,12496.28571,54708,51100,50304,45400.14286
1/8/2023,10,Agency_10,Sunday,50346,11507,Sports Event,0,172,61.85,55312,40161,22.54,22380,2486,45241,7295,33316.28571,7207.571429,61853,24866,52536,40523.85714
1/9/2023,10,Agency_10,Monday,52952,10660,Sports Event,1,172,63.61,55312,40161,21.83,50346,11507,39929,5684,35176.71429,7918.428571,63612,61853,45613,43095.14286
1/10/2023,10,Agency_10,Tuesday,23398,9414,Concert,0,172,32.81,55312,40161,37.48,52952,10660,27030,10236,34657.85714,7801,32812,63612,37266,42458.85714
1/11/2023,10,Agency_10,Wednesday,28381,4494,Sports Event,0,172,32.88,55312,40161,38.43,23398,9414,25435,5072,35078.71429,7718.428571,32875,32812,30507,42797.14286
1/12/2023,10,Agency_10,Thursday,27348,3755,None,0,172,31.1,55312,40161,39.47,28381,4494,31902,2402,34428.14286,7911.714286,31103,32875,34304,42339.85714
1/13/2023,10,Agency_10,Friday,21056,18221,Concert,1,172,39.28,55312,40161,32.49,27348,3755,36192,13066,32265.85714,8648.142857,39277,31103,49258,40914
1/14/2023,10,Agency_10,Saturday,40898,11707,Sports Event,1,172,52.61,55312,40161,27.12,21056,18221,22380,2486,34911.28571,9965.428571,52605,39277,24866,44876.71429
1/15/2023,10,Agency_10,Sunday,20111,18743,Concert,0,172,38.85,55312,40161,32.59,40898,11707,50346,11507,30592,10999.14286,38854,52605,61853,41591.14286
1/16/2023,10,Agency_10,Monday,26426,12176,Festival,1,172,38.6,55312,40161,34.03,20111,18743,52952,10660,26802.57143,11215.71429,38602,38854,63612,38018.28571
1/17/2023,10,Agency_10,Tuesday,47897,13906,Sports Event,1,172,61.8,55312,40161,22.09,26426,12176,23398,9414,30302.42857,11857.42857,61803,38602,32812,42159.85714
1/18/2023,10,Agency_10,Wednesday,38416,3798,Concert,1,172,42.22,55312,40161,33.9,47897,13906,28381,4494,31736,11758,42214,61803,32875,43494
1/19/2023,10,Agency_10,Thursday,20736,7524,None,1,172,28.26,55312,40161,40.13,38416,3798,27348,3755,30791.42857,12296.42857,28260,42214,31103,43087.85714
1/20/2023,10,Agency_10,Friday,31324,12866,Concert,1,172,44.19,55312,40161,31.1,20736,7524,21056,18221,32258.28571,11531.42857,44190,28260,39277,43789.71429
1/21/2023,10,Agency_10,Saturday,54774,21425,Sports Event,1,172,76.2,55312,40161,13.38,31324,12866,40898,11707,34240.57143,12919.71429,76199,44190,52605,47160.28571
1/22/2023,10,Agency_10,Sunday,32453,29061,Sports Event,1,172,61.52,55312,40161,19.2,54774,21425,20111,18743,36003.71429,14393.71429,61514,76199,38854,50397.42857
1/23/2023,10,Agency_10,Monday,35755,8493,Sports Event,0,172,44.25,55312,40161,31.95,32453,29061,26426,12176,37336.42857,13867.57143,44248,61514,38602,51204
1/24/2023,10,Agency_10,Tuesday,49621,23157,Sports Event,1,172,72.78,55312,40161,14.75,35755,8493,47897,13906,37582.71429,15189.14286,72778,44248,61803,52771.85714
1/25/2023,10,Agency_10,Wednesday,24971,10826,Concert,1,172,35.8,55312,40161,35.7,49621,23157,38416,3798,35662,16193.14286,35797,72778,42214,51855.14286
1/26/2023,10,Agency_10,Thursday,12160,9154,Sports Event,0,172,21.32,55312,40161,43.28,24971,10826,20736,7524,34436.85714,16426,21314,35797,28260,50862.85714
1/27/2023,10,Agency_10,Friday,28373,6889,None,1,172,35.26,55312,40161,36.76,12160,9154,31324,12866,34015.28571,15572.14286,35262,21314,44190,49587.42857
1/28/2023,10,Agency_10,Saturday,30108,1989,Sports Event,0,172,32.1,55312,40161,39.32,28373,6889,54774,21425,30491.57143,12795.57143,32097,35262,76199,43287.14286
1/29/2023,10,Agency_10,Sunday,51168,24473,Concert,1,172,75.64,55312,40161,13.05,30108,1989,32453,29061,33165.14286,12140.14286,75641,32097,61514,45305.28571
1/30/2023,10,Agency_10,Monday,22157,8232,None,1,172,30.39,55312,40161,38.93,51168,24473,35755,8493,31222.57143,12102.85714,30389,75641,44248,43325.42857
1/31/2023,10,Agency_10,Tuesday,23710,14075,Sports Event,1,172,37.79,55312,40161,34.06,22157,8232,49621,23157,27521,10805.42857,37785,30389,72778,38326.42857
2/1/2023,10,Agency_10,Wednesday,23442,4865,None,1,172,28.31,55312,40161,40.64,23710,14075,24971,10826,27302.57143,9953.857143,28307,37785,35797,37256.42857
2/2/2023,10,Agency_10,Thursday,24297,7160,Festival,0,172,31.46,55312,40161,38.61,23442,4865,12160,9154,29036.42857,9669,31457,28307,21314,38705.42857
2/3/2023,10,Agency_10,Friday,42728,5652,Concert,1,172,48.38,55312,40161,30.45,24297,7160,28373,6889,31087.14286,9492.285714,48380,31457,35262,40579.42857
2/4/2023,10,Agency_10,Saturday,42152,15213,Concert,1,172,57.37,55312,40161,24.04,42728,5652,30108,1989,32807.71429,11381.42857,57365,48380,32097,44189.14286
2/5/2023,10,Agency_10,Sunday,26107,18990,Festival,0,172,45.1,55312,40161,29.42,42152,15213,51168,24473,29227.57143,10598.14286,45097,57365,75641,39825.71429
2/6/2023,10,Agency_10,Monday,15732,3661,None,0,172,19.39,55312,40161,45.34,26107,18990,22157,8232,28309.71429,9945.142857,19393,45097,30389,38254.85714
2/7/2023,10,Agency_10,Tuesday,19640,12034,None,1,172,31.67,55312,40161,37.52,15732,3661,23710,14075,27728.28571,9653.571429,31674,19393,37785,37381.85714
2/8/2023,10,Agency_10,Wednesday,34146,5314,Sports Event,0,172,39.46,55312,40161,34.98,19640,12034,23442,4865,29257.42857,9717.714286,39460,31674,28307,38975.14286
2/9/2023,10,Agency_10,Thursday,49785,12854,Sports Event,1,172,62.64,55312,40161,21.88,34146,5314,24297,7160,32898.57143,10531.14286,62639,39460,31457,43429.71429
2/10/2023,10,Agency_10,Friday,41507,10260,Festival,1,172,51.77,55312,40161,27.83,49785,12854,42728,5652,32724.14286,11189.42857,51767,62639,48380,43913.57143
2/11/2023,10,Agency_10,Saturday,19502,7377,None,0,172,26.88,55312,40161,40.85,41507,10260,42152,15213,29488.42857,10070,26879,51767,57365,39558.42857
2/12/2023,10,Agency_10,Sunday,26947,15712,None,1,172,42.66,55312,40161,31.3,19502,7377,26107,18990,29608.42857,9601.714286,42659,26879,45097,39210.14286
2/13/2023,10,Agency_10,Monday,20479,13722,Concert,0,172,34.2,55312,40161,35.92,26947,15712,15732,3661,30286.57143,11039,34201,42659,19393,41325.57143
2/14/2023,10,Agency_10,Tuesday,29164,9516,Sports Event,0,172,38.68,55312,40161,34.52,20479,13722,19640,12034,31647.14286,10679.28571,38680,34201,31674,42326.42857
2/15/2023,10,Agency_10,Wednesday,31414,5234,None,1,172,36.65,55312,40161,36.4,29164,9516,34146,5314,31256.85714,10667.85714,36648,38680,39460,41924.71429
2/16/2023,10,Agency_10,Thursday,47425,0,Festival,1,172,47.43,55312,40161,32.06,31414,5234,49785,12854,30919.71429,8831.571429,47425,36648,62639,39751.28571
2/17/2023,10,Agency_10,Friday,31980,7499,Sports Event,1,172,39.48,55312,40161,34.53,47425,0,41507,10260,29558.71429,8437.142857,39479,47425,51767,37995.85714
2/18/2023,10,Agency_10,Saturday,32132,14139,Festival,1,172,46.27,55312,40161,29.8,31980,7499,19502,7377,31363,9403.142857,46271,39479,26879,40766.14286
2/19/2023,10,Agency_10,Sunday,39470,14155,Concert,0,172,53.63,55312,40161,26.12,32132,14139,26947,15712,33152,9180.714286,53625,46271,42659,42332.71429
2/20/2023,10,Agency_10,Monday,31806,6235,Concert,0,172,38.04,55312,40161,35.5,39470,14155,20479,13722,34770.14286,8111.142857,38041,53625,34201,42881.28571
2/21/2023,10,Agency_10,Tuesday,32767,8921,Festival,0,172,41.69,55312,40161,33.14,31806,6235,29164,9516,35284.85714,8026.142857,41688,38041,38680,43311
2/22/2023,10,Agency_10,Wednesday,37020,11140,Sports Event,0,172,48.16,55312,40161,29.46,32767,8921,31414,5234,36085.71429,8869.857143,48160,41688,36648,44955.57143
2/23/2023,10,Agency_10,Thursday,26197,4487,None,1,172,30.68,55312,40161,39.53,37020,11140,47425,0,33053.14286,9510.857143,30684,48160,47425,42564
2/24/2023,10,Agency_10,Friday,16735,3900,None,0,172,20.64,55312,40161,44.67,26197,4487,31980,7499,30875.28571,8996.714286,20635,30684,39479,39872
2/25/2023,10,Agency_10,Saturday,43109,17128,Concert,1,172,60.24,55312,40161,22.22,16735,3900,32132,14139,32443.42857,9423.714286,60237,20635,46271,41867.14286
2/26/2023,10,Agency_10,Sunday,55165,15151,Sports Event,1,172,70.32,55312,40161,17.58,43109,17128,39470,14155,34685.57143,9566,70316,60237,53625,44251.57143
2/27/2023,10,Agency_10,Monday,39156,12580,Sports Event,1,172,51.74,55312,40161,27.38,55165,15151,31806,6235,35735.57143,10472.42857,51736,70316,38041,46208
2/28/2023,10,Agency_10,Tuesday,33969,7494,Festival,1,172,41.46,55312,40161,33.54,39156,12580,32767,8921,35907.28571,10268.57143,41463,51736,41688,46175.85714
3/1/2023,10,Agency_10,Wednesday,16833,6135,Festival,0,172,22.97,55312,40161,43.06,33969,7494,37020,11140,33023.42857,9553.571429,22968,41463,48160,42577
3/2/2023,10,Agency_10,Thursday,33547,6109,Concert,0,172,39.66,55312,40161,34.72,16833,6135,26197,4487,34073.42857,9785.285714,39656,22968,30684,43858.71429
3/3/2023,10,Agency_10,Friday,18810,5932,None,0,172,24.74,55312,40161,42.21,33547,6109,16735,3900,34369.85714,10075.57143,24742,39656,20635,44445.42857
3/4/2023,10,Agency_10,Saturday,27123,3692,None,0,172,30.82,55312,40161,39.62,18810,5932,43109,17128,32086.14286,8156.142857,30815,24742,60237,40242.28571
3/5/2023,10,Agency_10,Sunday,44973,16031,Concert,0,172,61,55312,40161,22.06,27123,3692,55165,15151,30630.14286,8281.857143,61004,30815,70316,38912
3/6/2023,10,Agency_10,Monday,27982,7977,Concert,1,172,35.96,55312,40161,36.19,44973,16031,39156,12580,29033.85714,7624.285714,35959,61004,51736,36658.14286
3/7/2023,10,Agency_10,Tuesday,38932,8000,Concert,0,172,46.93,55312,40161,30.7,27982,7977,33969,7494,29742.85714,7696.571429,46932,35959,41463,37439.42857
3/8/2023,10,Agency_10,Wednesday,13351,3740,Sports Event,0,172,17.09,55312,40161,46.47,38932,8000,16833,6135,29245.42857,7354.428571,17091,46932,22968,36599.85714
3/9/2023,10,Agency_10,Thursday,24378,3742,None,1,172,28.12,55312,40161,40.96,13351,3740,33547,6109,27935.57143,7016.285714,28120,17091,39656,34951.85714
3/10/2023,10,Agency_10,Friday,26898,8608,Sports Event,0,172,35.51,55312,40161,36.29,24378,3742,18810,5932,29091,7398.571429,35506,28120,24742,36489.57143
3/11/2023,10,Agency_10,Saturday,63907,13672,Sports Event,1,172,77.58,55312,40161,14.24,26898,8608,27123,3692,34345.85714,8824.285714,77579,35506,30815,43170.14286
3/12/2023,10,Agency_10,Sunday,30434,10214,None,0,172,40.65,55312,40161,33.4,63907,13672,44973,16031,32268.85714,7993.285714,40648,77579,61004,40262.14286
3/13/2023,10,Agency_10,Monday,40756,9467,Concert,0,172,50.22,55312,40161,28.76,30434,10214,27982,7977,34093.71429,8206.142857,50223,40648,35959,42299.85714
3/14/2023,10,Agency_10,Tuesday,19856,14091,Sports Event,1,172,33.95,55312,40161,35.98,40756,9467,38932,8000,31368.57143,9076.285714,33947,50223,46932,40444.85714
3/15/2023,10,Agency_10,Wednesday,37861,8222,Sports Event,0,172,46.08,55312,40161,31.08,19856,14091,13351,3740,34870,9716.571429,46083,33947,17091,44586.57143
3/16/2023,10,Agency_10,Thursday,43083,11422,Sports Event,0,172,54.51,55312,40161,26.23,37861,8222,24378,3742,37542.14286,10813.71429,54505,46083,28120,48355.85714
3/17/2023,10,Agency_10,Friday,44539,17069,Concert,1,172,61.61,55312,40161,21.55,43083,11422,26898,8608,40062.28571,12022.42857,61608,54505,35506,52084.71429
3/18/2023,10,Agency_10,Saturday,38998,30,Sports Event,0,172,39.03,55312,40161,36.25,44539,17069,63907,13672,36503.85714,10073.57143,39028,61608,77579,46577.42857
3/19/2023,10,Agency_10,Sunday,31507,16340,Festival,0,172,47.85,55312,40161,28.58,38998,30,30434,10214,36657.14286,10948.71429,47847,39028,40648,47605.85714
3/20/2023,10,Agency_10,Monday,20750,6374,None,1,172,27.12,55312,40161,40.93,31507,16340,40756,9467,33799.14286,10506.85714,27124,47847,50223,44306
3/21/2023,10,Agency_10,Tuesday,28811,20389,Sports Event,1,172,49.2,55312,40161,27.09,20750,6374,19856,14091,35078.42857,11406.57143,49200,27124,33947,46485
3/22/2023,10,Agency_10,Wednesday,42610,5494,Festival,0,172,48.1,55312,40161,30.62,28811,20389,37861,8222,35756.85714,11016.85714,48104,49200,46083,46773.71429
3/23/2023,10,Agency_10,Thursday,40435,8660,Sports Event,1,172,49.1,55312,40161,29.49,42610,5494,43083,11422,35378.57143,10622.28571,49095,48104,54505,46000.85714
3/24/2023,10,Agency_10,Friday,44994,14325,Sports Event,1,172,59.32,55312,40161,23.24,40435,8660,44539,17069,35443.57143,10230.28571,59319,49095,61608,45673.85714
3/25/2023,10,Agency_10,Saturday,43304,12515,Concert,0,172,55.82,55312,40161,25.36,44994,14325,38998,30,36058.71429,12013.85714,55819,59319,39028,48072.57143
3/26/2023,10,Agency_10,Sunday,54096,5358,None,1,172,59.45,55312,40161,24.97,43304,12515,31507,16340,39285.71429,10445,59454,55819,47847,49730.71429
3/27/2023,10,Agency_10,Monday,17169,7162,Festival,0,172,24.33,55312,40161,42.17,54096,5358,20750,6374,38774.14286,10557.57143,24331,59454,27124,49331.71429
3/28/2023,10,Agency_10,Tuesday,23712,4795,Festival,1,172,28.51,55312,40161,40.56,17169,7162,28811,20389,38045.71429,8329.857143,28507,24331,49200,46375.57143
3/29/2023,10,Agency_10,Wednesday,22489,5363,Sports Event,0,172,27.85,55312,40161,40.77,23712,4795,42610,5494,35171.28571,8311.142857,27852,28507,48104,43482.42857
3/30/2023,10,Agency_10,Thursday,29690,14365,Sports Event,1,172,44.06,55312,40161,30.87,22489,5363,40435,8660,33636.28571,9126.142857,44055,27852,49095,42762.42857
3/31/2023,10,Agency_10,Friday,34064,11043,Sports Event,1,172,45.11,55312,40161,31.01,29690,14365,44994,14325,32074.85714,8657.285714,45107,44055,59319,40732.14286
4/1/2023,10,Agency_10,Saturday,29365,4507,None,0,172,33.87,55312,40161,37.93,34064,11043,43304,12515,30083.57143,7513.285714,33872,45107,55819,37596.85714
4/2/2023,10,Agency_10,Sunday,33618,12665,Festival,0,172,46.28,55312,40161,30.09,29365,4507,54096,5358,27158.14286,8557.142857,46283,33872,59454,35715.28571
4/3/2023,10,Agency_10,Monday,20069,547,Sports Event,1,172,20.62,55312,40161,45.35,33618,12665,17169,7162,27572.42857,7612.142857,20616,46283,24331,35184.57143
4/4/2023,10,Agency_10,Tuesday,32595,10172,Sports Event,0,172,42.77,55312,40161,32.35,20069,547,23712,4795,28841.42857,8380.285714,42767,20616,28507,37221.71429
4/5/2023,10,Agency_10,Wednesday,59125,12652,Concert,1,172,71.78,55312,40161,17.35,32595,10172,22489,5363,34075.14286,9421.571429,71777,42767,27852,43496.71429
4/6/2023,10,Agency_10,Thursday,36147,7835,Sports Event,0,172,43.98,55312,40161,32.21,59125,12652,29690,14365,34997.57143,8488.714286,43982,71777,44055,43486.28571
4/7/2023,10,Agency_10,Friday,41897,19834,Festival,1,172,61.73,55312,40161,20.94,36147,7835,34064,11043,36116.57143,9744.571429,61731,43982,45107,45861.14286
4/8/2023,10,Agency_10,Saturday,21949,18028,Sports Event,1,172,39.98,55312,40161,32.17,41897,19834,29365,4507,35057.14286,11676.14286,39977,61731,33872,46733.28571
4/9/2023,10,Agency_10,Sunday,55218,12296,Sports Event,0,172,67.52,55312,40161,19.55,21949,18028,33618,12665,38142.85714,11623.42857,67514,39977,46283,49766.28571
4/10/2023,10,Agency_10,Monday,55091,8903,Concert,1,172,63.99,55312,40161,21.99,55218,12296,20069,547,43146,12817.14286,63994,67514,20616,55963.14286
4/11/2023,10,Agency_10,Tuesday,25790,7093,None,1,172,32.88,55312,40161,37.91,55091,8903,32595,10172,42173.85714,12377.28571,32883,63994,42767,54551.14286
4/12/2023,10,Agency_10,Wednesday,13368,4527,Concert,0,172,17.9,55312,40161,45.92,25790,7093,59125,12652,35637.14286,11216.57143,17895,32883,71777,46853.71429
4/13/2023,10,Agency_10,Thursday,21772,11294,Concert,0,172,33.07,55312,40161,36.98,13368,4527,36147,7835,33583.57143,11710.71429,33066,17895,43982,45294.28571
4/14/2023,10,Agency_10,Friday,36540,9601,Sports Event,0,172,46.14,55312,40161,30.78,21772,11294,41897,19834,32818.28571,10248.85714,46141,33066,61731,43067.14286
4/15/2023,10,Agency_10,Saturday,56440,14452,Sports Event,1,172,70.89,55312,40161,17.43,36540,9601,21949,18028,37745.57143,9738,70892,46141,39977,47483.57143
4/16/2023,10,Agency_10,Sunday,46816,11087,Festival,0,172,57.9,55312,40161,24.6,56440,14452,55218,12296,36545.28571,9565.285714,57903,70892,67514,46110.57143
4/17/2023,10,Agency_10,Monday,30433,7595,Concert,0,172,38.03,55312,40161,35.24,46816,11087,55091,8903,33022.71429,9378.428571,38028,57903,63994,42401.14286
4/18/2023,10,Agency_10,Tuesday,30448,5819,None,1,172,36.27,55312,40161,36.47,30433,7595,25790,7093,33688.14286,9196.428571,36267,38028,32883,42884.57143
4/19/2023,10,Agency_10,Wednesday,48519,6509,Festival,1,172,55.03,55312,40161,26.95,30448,5819,13368,4527,38709.71429,9479.571429,55028,36267,17895,48189.28571
4/20/2023,10,Agency_10,Thursday,21757,10835,Concert,0,172,32.59,55312,40161,37.3,48519,6509,21772,11294,38707.57143,9414,32592,55028,33066,48121.57143
4/21/2023,10,Agency_10,Friday,19557,4092,None,0,172,23.65,55312,40161,43.13,21757,10835,36540,9601,36281.42857,8627,23649,32592,46141,44908.42857
4/22/2023,10,Agency_10,Saturday,57213,11710,Festival,1,172,68.92,55312,40161,18.96,19557,4092,56440,14452,36391.85714,8235.285714,68923,23649,70892,44627.14286
4/23/2023,10,Agency_10,Sunday,22797,10137,None,0,172,32.94,55312,40161,37.27,57213,11710,46816,11087,32960.57143,8099.571429,32934,68923,57903,41060.14286
4/24/2023,10,Agency_10,Monday,27695,8144,None,0,172,35.84,55312,40161,36.22,22797,10137,30433,7595,32569.42857,8178,35839,32934,38028,40747.42857
4/25/2023,10,Agency_10,Tuesday,36248,17757,Sports Event,1,172,54.01,55312,40161,25.21,27695,8144,30448,5819,33398,9883.428571,54005,35839,36267,43281.42857
4/26/2023,10,Agency_10,Wednesday,29747,7582,Festival,1,172,37.33,55312,40161,35.59,36248,17757,48519,6509,30716.28571,10036.71429,37329,54005,55028,40753
4/27/2023,10,Agency_10,Thursday,10721,11683,None,1,172,22.4,55312,40161,42.23,29747,7582,21757,10835,29139.71429,10157.85714,22404,37329,32592,39297.57143
4/28/2023,10,Agency_10,Friday,23520,8068,Concert,0,172,31.59,55312,40161,38.36,10721,11683,19557,4092,29705.85714,10725.85714,31588,22404,23649,40431.71429
4/29/2023,10,Agency_10,Saturday,24098,11629,None,1,172,35.73,55312,40161,35.58,23520,8068,57213,11710,24975.14286,10714.28571,35727,31588,68923,35689.42857
4/30/2023,10,Agency_10,Sunday,32617,5281,Sports Event,0,172,37.9,55312,40161,35.76,24098,11629,22797,10137,26378,10020.57143,37898,35727,32934,36398.57143
5/1/2023,10,Agency_10,Monday,22208,2132,None,0,172,24.34,55312,40161,43.17,32617,5281,27695,8144,25594.14286,9161.714286,24340,37898,35839,34755.85714
5/2/2023,10,Agency_10,Tuesday,15812,786,None,0,172,16.6,55312,40161,47.31,22208,2132,36248,17757,22674.71429,6737.285714,16598,24340,54005,29412
5/3/2023,10,Agency_10,Wednesday,19320,9106,Concert,0,172,28.43,55312,40161,39.73,15812,786,29747,7582,21185.14286,6955,28426,16598,37329,28140.14286
5/4/2023,10,Agency_10,Thursday,19845,4848,Concert,1,172,24.69,55312,40161,42.45,19320,9106,10721,11683,22488.57143,5978.571429,24693,28426,22404,28467.14286
5/5/2023,10,Agency_10,Friday,38976,9310,Concert,1,172,48.29,55312,40161,29.76,19845,4848,23520,8068,24696.57143,6156,48286,24693,31588,30852.57143
5/6/2023,10,Agency_10,Saturday,70106,26815,Sports Event,1,172,96.92,55312,40161,1.94,38976,9310,24098,11629,31269.14286,8325.428571,96921,48286,35727,39594.57143
5/7/2023,10,Agency_10,Sunday,18792,7948,None,0,172,26.74,55312,40161,40.81,70106,26815,32617,5281,29294.14286,8706.428571,26740,96921,37898,38000.57143
5/8/2023,10,Agency_10,Monday,46304,9055,Festival,1,172,55.36,55312,40161,26.28,18792,7948,22208,2132,32736.42857,9695.428571,55359,26740,24340,42431.85714
5/9/2023,10,Agency_10,Tuesday,18783,8457,Concert,0,172,27.24,55312,40161,40.46,46304,9055,15812,786,33160.85714,10791.28571,27240,55359,16598,43952.14286
5/10/2023,10,Agency_10,Wednesday,37313,9824,Concert,1,172,47.14,55312,40161,30.23,18783,8457,19320,9106,35731.28571,10893.85714,47137,27240,28426,46625.14286
5/11/2023,10,Agency_10,Thursday,33316,5946,Sports Event,0,172,39.26,55312,40161,34.95,37313,9824,19845,4848,37655.71429,11050.71429,39262,47137,24693,48706.42857
5/12/2023,10,Agency_10,Friday,27768,12418,Concert,1,172,40.19,55312,40161,33.19,33316,5946,38976,9310,36054.57143,11494.71429,40186,39262,48286,47549.28571
5/13/2023,10,Agency_10,Saturday,51313,8186,Festival,1,172,59.5,55312,40161,24.38,27768,12418,70106,26815,33369.85714,8833.428571,59499,40186,96921,42203.28571
5/14/2023,10,Agency_10,Sunday,44352,3224,Concert,0,172,47.58,55312,40161,31.34,51313,8186,18792,7948,37021.28571,8158.571429,47576,59499,26740,45179.85714
5/15/2023,10,Agency_10,Monday,33362,10669,Festival,1,172,44.03,55312,40161,31.62,44352,3224,46304,9055,35172.42857,8389.142857,44031,47576,55359,43561.57143
5/16/2023,10,Agency_10,Tuesday,32795,9208,Sports Event,1,172,42,55312,40161,32.93,33362,10669,18783,8457,37174.14286,8496.428571,42003,44031,27240,45670.57143
5/17/2023,10,Agency_10,Wednesday,44032,5606,Concert,0,172,49.64,55312,40161,29.83,32795,9208,37313,9824,38134,7893.857143,49638,42003,47137,46027.85714
5/18/2023,10,Agency_10,Thursday,48309,9985,Sports Event,0,172,58.29,55312,40161,24.62,44032,5606,33316,5946,40275.85714,8470.857143,58294,49638,39262,48746.71429
5/19/2023,10,Agency_10,Friday,39897,14165,Concert,1,172,54.06,55312,40161,25.9,48309,9985,27768,12418,42008.57143,8720.428571,54062,58294,40186,50729
5/20/2023,10,Agency_10,Saturday,76398,9319,Sports Event,1,172,85.72,55312,40161,11.05,39897,14165,51313,8186,45592.14286,8882.285714,85717,54062,59499,54474.42857
5/21/2023,10,Agency_10,Sunday,33688,10798,Sports Event,1,172,44.49,55312,40161,31.37,76398,9319,44352,3224,44068.71429,9964.285714,44486,85717,47576,54033
5/22/2023,10,Agency_10,Monday,26208,2167,None,1,172,28.38,55312,40161,41.15,33688,10798,33362,10669,43046.71429,8749.714286,28375,44486,44031,51796.42857
5/23/2023,10,Agency_10,Tuesday,30166,14257,Concert,0,172,44.42,55312,40161,30.7,26208,2167,32795,9208,42671.14286,9471,44423,28375,42003,52142.14286
5/24/2023,10,Agency_10,Wednesday,20757,4414,None,0,172,25.17,55312,40161,42.3,30166,14257,44032,5606,39346.14286,9300.714286,25171,44423,49638,48646.85714
5/25/2023,10,Agency_10,Thursday,32972,16176,Festival,1,172,49.15,55312,40161,27.96,20757,4414,48309,9985,37155.14286,10185.14286,49148,25171,58294,47340.28571
5/26/2023,10,Agency_10,Friday,23805,14776,Sports Event,0,172,38.58,55312,40161,33.52,32972,16176,39897,14165,34856.28571,10272.42857,38581,49148,54062,45128.71429
5/27/2023,10,Agency_10,Saturday,53398,12183,Sports Event,0,172,65.58,55312,40161,20.54,23805,14776,76398,9319,31570.57143,10681.57143,65581,38581,85717,42252.14286
5/28/2023,10,Agency_10,Sunday,35895,15604,Sports Event,0,172,51.5,55312,40161,26.9,53398,12183,33688,10798,31885.85714,11368.14286,51499,65581,44486,43254
5/29/2023,10,Agency_10,Monday,38209,5759,Concert,0,172,43.97,55312,40161,32.63,35895,15604,26208,2167,33600.28571,11881.28571,43968,51499,28375,45481.57143
5/30/2023,10,Agency_10,Tuesday,33865,5604,Festival,1,172,39.47,55312,40161,34.91,38209,5759,30166,14257,34128.71429,10645.14286,39469,43968,44423,44773.85714
5/31/2023,10,Agency_10,Wednesday,42987,15072,Sports Event,1,172,58.06,55312,40161,23.72,33865,5604,20757,4414,37304.42857,12167.71429,58059,39469,25171,49472.14286
6/1/2023,10,Agency_10,Thursday,25837,9731,Festival,1,172,35.57,55312,40161,36.04,42987,15072,32972,16176,36285.14286,11247,35568,58059,49148,47532.14286
6/2/2023,10,Agency_10,Friday,17241,4482,None,1,172,21.72,55312,40161,44.01,25837,9731,23805,14776,35347.42857,9776.428571,21723,35568,38581,45123.85714
6/3/2023,10,Agency_10,Saturday,53246,10931,Concert,1,172,64.18,55312,40161,21.49,17241,4482,53398,12183,35325.71429,9597.571429,64177,21723,65581,44923.28571
6/4/2023,10,Agency_10,Sunday,33291,3856,Sports Event,0,172,37.15,55312,40161,36.42,53246,10931,35895,15604,34953.71429,7919.285714,37147,64177,51499,42873
6/5/2023,10,Agency_10,Monday,40821,11688,Sports Event,1,172,52.51,55312,40161,27.18,33291,3856,38209,5759,35326.85714,8766.285714,52509,37147,43968,44093.14286
6/6/2023,10,Agency_10,Tuesday,24532,7855,Sports Event,0,172,32.39,55312,40161,38,40821,11688,33865,5604,33993.57143,9087.857143,32387,52509,39469,43081.42857
6/7/2023,10,Agency_10,Wednesday,31351,5729,Festival,0,172,37.08,55312,40161,36.08,24532,7855,42987,15072,32331.28571,7753.142857,37080,32387,58059,40084.42857
6/8/2023,10,Agency_10,Thursday,16403,12055,None,1,172,28.46,55312,40161,39.13,31351,5729,25837,9731,30983.57143,8085.142857,28458,37080,35568,39068.71429
6/9/2023,10,Agency_10,Friday,25249,8170,Sports Event,0,172,33.42,55312,40161,37.42,16403,12055,17241,4482,32127.57143,8612,33419,28458,21723,40739.57143
6/10/2023,10,Agency_10,Saturday,45097,26648,Festival,0,172,71.75,55312,40161,14.57,25249,8170,53246,10931,30963.42857,10857.28571,71745,33419,64177,41820.71429
6/11/2023,10,Agency_10,Sunday,21492,10736,None,1,172,32.23,55312,40161,37.51,45097,26648,33291,3856,29277.85714,11840.14286,32228,71745,37147,41118
6/12/2023,10,Agency_10,Monday,24693,6667,Festival,0,172,31.36,55312,40161,38.76,21492,10736,40821,11688,26973.85714,11122.85714,31360,32228,52509,38096.71429
6/13/2023,10,Agency_10,Tuesday,16398,2748,None,0,172,19.15,55312,40161,45.65,24693,6667,24532,7855,25811.85714,10393.28571,19146,31360,32387,36205.14286
6/14/2023,10,Agency_10,Wednesday,29689,3485,Festival,0,172,33.17,55312,40161,38.48,16398,2748,31351,5729,25574.42857,10072.71429,33174,19146,37080,35647.14286
6/15/2023,10,Agency_10,Thursday,48231,12161,Festival,1,172,60.39,55312,40161,23.14,29689,3485,16403,12055,30121.28571,10087.85714,60392,33174,28458,40209.14286
6/16/2023,10,Agency_10,Friday,22112,4067,None,0,172,26.18,55312,40161,41.87,48231,12161,25249,8170,29673.14286,9501.714286,26179,60392,33419,39174.85714
6/17/2023,10,Agency_10,Saturday,42501,17249,Festival,1,172,59.75,55312,40161,22.44,22112,4067,45097,26648,29302.28571,8159,59750,26179,71745,37461.28571
6/18/2023,10,Agency_10,Sunday,25522,9467,Festival,0,172,34.99,55312,40161,36.38,42501,17249,21492,10736,29878,7977.714286,34989,59750,32228,37855.71429
6/19/2023,10,Agency_10,Monday,15701,3218,None,0,172,18.92,55312,40161,45.67,25522,9467,24693,6667,28593.42857,7485,18919,34989,31360,36078.42857
6/20/2023,10,Agency_10,Tuesday,18427,18273,Sports Event,1,172,36.7,55312,40161,33.76,15701,3218,16398,2748,28883.28571,9702.857143,36700,18919,19146,38586.14286
6/21/2023,10,Agency_10,Wednesday,21537,10256,None,1,172,31.79,55312,40161,37.82,18427,18273,29689,3485,27718.71429,10670.14286,31793,36700,33174,38388.85714
6/22/2023,10,Agency_10,Thursday,38014,4127,Festival,0,172,42.14,55312,40161,33.87,21537,10256,48231,12161,26259.14286,9522.428571,42141,31793,60392,35781.57143
6/23/2023,10,Agency_10,Friday,28386,24087,Concert,1,172,52.47,55312,40161,24.71,38014,4127,22112,4067,27155.42857,12382.42857,52473,42141,26179,39537.85714
6/24/2023,10,Agency_10,Saturday,67284,15271,Festival,1,172,82.56,55312,40161,11.44,28386,24087,42501,17249,30695.85714,12099.85714,82555,52473,59750,42795.71429
6/25/2023,10,Agency_10,Sunday,49809,11565,Concert,1,172,61.37,55312,40161,22.77,67284,15271,25522,9467,34165.42857,12399.57143,61374,82555,34989,46565
6/26/2023,10,Agency_10,Monday,33241,6060,Concert,0,172,39.3,55312,40161,34.91,49809,11565,15701,3218,36671.14286,12805.57143,39301,61374,18919,49476.71429
6/27/2023,10,Agency_10,Tuesday,14757,4005,Festival,0,172,18.76,55312,40161,45.59,33241,6060,18427,18273,36146.85714,10767.28571,18762,39301,36700,46914.14286
6/28/2023,10,Agency_10,Wednesday,39204,6514,Festival,1,172,45.72,55312,40161,31.61,14757,4005,21537,10256,38670.71429,10232.71429,45718,18762,31793,48903.42857
6/29/2023,10,Agency_10,Thursday,19663,2850,None,0,172,22.51,55312,40161,43.94,39204,6514,38014,4127,36049.14286,10050.28571,22513,45718,42141,46099.42857
6/30/2023,10,Agency_10,Friday,31371,15960,Sports Event,1,172,47.33,55312,40161,28.91,19663,2850,28386,24087,36475.57143,8889.285714,47331,22513,52473,45364.85714
7/1/2023,10,Agency_10,Saturday,25484,6474,None,0,172,31.96,55312,40161,38.49,31371,15960,67284,15271,30504.14286,7632.571429,31958,47331,82555,38136.71429
7/2/2023,10,Agency_10,Sunday,38054,10849,None,1,172,48.9,55312,40161,29.15,25484,6474,49809,11565,28824.85714,7530.285714,48903,31958,61374,36355.14286
7/3/2023,10,Agency_10,Monday,53102,9710,Concert,1,172,62.81,55312,40161,22.42,38054,10849,33241,6060,31662.14286,8051.714286,62812,48903,39301,39713.85714
7/4/2023,10,Agency_10,Tuesday,34809,5704,Concert,1,172,40.51,55312,40161,34.37,53102,9710,14757,4005,34526.71429,8294.428571,40513,62812,18762,42821.14286
7/5/2023,10,Agency_10,Wednesday,23211,9700,None,1,172,32.91,55312,40161,37.37,34809,5704,39204,6514,32242,8749.571429,32911,40513,45718,40991.57143
7/6/2023,10,Agency_10,Thursday,51673,16469,Sports Event,1,172,68.14,55312,40161,18.4,23211,9700,19663,2850,36814.85714,10695.14286,68142,32911,22513,47510
7/7/2023,10,Agency_10,Friday,21506,17055,Festival,1,172,38.56,55312,40161,33.08,51673,16469,31371,15960,35405.57143,10851.57143,38561,68142,47331,46257.14286
7/8/2023,10,Agency_10,Saturday,25288,21026,Sports Event,1,172,46.32,55312,40161,28.41,21506,17055,25484,6474,35377.57143,12930.42857,46314,38561,31958,48308
7/9/2023,10,Agency_10,Sunday,42496,19817,Sports Event,1,172,62.31,55312,40161,20.65,25288,21026,38054,10849,36012.14286,14211.57143,62313,46314,48903,50223.71429
7/10/2023,10,Agency_10,Monday,20005,12481,Concert,0,172,32.49,55312,40161,37.03,42496,19817,53102,9710,31284,14607.42857,32486,62313,62812,45891.42857
7/11/2023,10,Agency_10,Tuesday,24716,8717,Concert,1,172,33.43,55312,40161,37.31,20005,12481,34809,5704,29842.14286,15037.85714,33433,32486,40513,44880
7/12/2023,10,Agency_10,Wednesday,22513,2534,Sports Event,0,172,25.05,55312,40161,42.74,24716,8717,23211,9700,29742.42857,14014.14286,25047,33433,32911,43756.57143
7/13/2023,10,Agency_10,Thursday,20472,8612,None,0,172,29.08,55312,40161,39.5,22513,2534,51673,16469,25285.14286,12891.71429,29084,25047,68142,38176.85714
7/14/2023,10,Agency_10,Friday,65001,12361,Sports Event,1,172,77.36,55312,40161,14.61,20472,8612,21506,17055,31498.71429,12221.14286,77362,29084,38561,43719.85714
7/15/2023,10,Agency_10,Saturday,30699,7103,None,0,172,37.8,55312,40161,35.45,65001,12361,25288,21026,32271.71429,10232.14286,37802,77362,46314,42503.85714
7/16/2023,10,Agency_10,Sunday,40489,9536,Festival,0,172,50.03,55312,40161,28.85,30699,7103,42496,19817,31985,8763.428571,50025,37802,62313,40748.42857
7/17/2023,10,Agency_10,Monday,31462,10325,Sports Event,0,172,41.79,55312,40161,32.81,40489,9536,20005,12481,33621.71429,8455.428571,41787,50025,32486,42077.14286
7/18/2023,10,Agency_10,Tuesday,22239,6783,None,1,172,29.02,55312,40161,39.9,31462,10325,24716,8717,33267.85714,8179.142857,29022,41787,33433,41447
7/19/2023,10,Agency_10,Wednesday,29560,11308,Festival,0,172,40.87,55312,40161,33.07,22239,6783,22513,2534,34274.57143,9432.571429,40868,29022,25047,43707.14286
7/20/2023,10,Agency_10,Thursday,22003,8323,Concert,0,172,30.33,55312,40161,38.94,29560,11308,20472,8612,34493.28571,9391.285714,30326,40868,29084,43884.57143
7/21/2023,10,Agency_10,Friday,57642,17440,Festival,1,172,75.08,55312,40161,14.74,22003,8323,65001,12361,33442,10116.85714,75082,30326,77362,43558.85714
7/22/2023,10,Agency_10,Saturday,62583,15618,Festival,1,172,78.2,55312,40161,13.54,57642,17440,30699,7103,37996.85714,11333.28571,78201,75082,37802,49330.14286
7/23/2023,10,Agency_10,Sunday,50553,21670,Festival,1,172,72.22,55312,40161,15.32,62583,15618,40489,9536,39434.57143,13066.71429,72223,78201,50025,52501.28571
7/24/2023,10,Agency_10,Monday,27801,1096,None,0,172,28.9,55312,40161,41.1,50553,21670,31462,10325,38911.57143,11748.28571,28897,72223,41787,50659.85714
7/25/2023,10,Agency_10,Tuesday,26172,18130,Concert,1,172,44.3,55312,40161,29.99,27801,1096,22239,6783,39473.42857,13369.28571,44302,28897,29022,52842.71429
7/26/2023,10,Agency_10,Wednesday,24199,5118,None,1,172,29.32,55312,40161,40.09,26172,18130,29560,11308,38707.57143,12485,29317,44302,40868,51192.57143
7/27/2023,10,Agency_10,Thursday,20593,6611,Festival,0,172,27.2,55312,40161,40.84,24199,5118,22003,8323,38506.14286,12240.42857,27204,29317,30326,50746.57143
7/28/2023,10,Agency_10,Friday,25326,21853,Concert,1,172,47.18,55312,40161,27.81,20593,6611,57642,17440,33889.57143,12870.85714,47179,27204,75082,46760.42857
7/29/2023,10,Agency_10,Saturday,23864,6349,None,0,172,30.21,55312,40161,39.39,25326,21853,62583,15618,28358.28571,11546.71429,30213,47179,78201,39905
7/30/2023,10,Agency_10,Sunday,41292,15302,Festival,0,172,56.59,55312,40161,24.41,23864,6349,50553,21670,27035.28571,10637,56594,30213,72223,37672.28571
7/31/2023,10,Agency_10,Monday,32147,10005,None,1,172,42.15,55312,40161,32.69,41292,15302,27801,1096,27656.14286,11909.71429,42152,56594,28897,39565.85714
8/1/2023,10,Agency_10,Tuesday,32847,10481,Sports Event,1,172,43.33,55312,40161,32.01,32147,10005,26172,18130,28609.71429,10817,43328,42152,44302,39426.71429
8/2/2023,10,Agency_10,Wednesday,46497,9389,Sports Event,1,172,55.89,55312,40161,25.95,32847,10481,24199,5118,31795.14286,11427.14286,55886,43328,29317,43222.28571
8/3/2023,10,Agency_10,Thursday,38949,13796,Sports Event,1,172,52.75,55312,40161,26.64,46497,9389,20593,6611,34417.42857,12453.57143,52745,55886,27204,46871
8/4/2023,10,Agency_10,Friday,35887,2454,Concert,0,172,38.34,55312,40161,36.11,38949,13796,25326,21853,35926.14286,9682.285714,38341,52745,47179,45608.42857
8/5/2023,10,Agency_10,Saturday,55160,14022,Sports Event,1,172,69.18,55312,40161,18.37,35887,2454,23864,6349,40397,10778.42857,69182,38341,30213,51175.42857
8/6/2023,10,Agency_10,Sunday,42366,14482,Sports Event,0,172,56.85,55312,40161,24.45,55160,14022,41292,15302,40550.42857,10661.28571,56848,69182,56594,51211.71429
8/7/2023,10,Agency_10,Monday,42058,13100,Festival,0,172,55.16,55312,40161,25.57,42366,14482,32147,10005,41966.28571,11103.42857,55158,56848,42152,53069.71429
8/8/2023,10,Agency_10,Tuesday,52127,18771,Sports Event,1,172,70.9,55312,40161,16.57,42058,13100,32847,10481,44720.57143,12287.71429,70898,55158,43328,57008.28571
8/9/2023,10,Agency_10,Wednesday,41839,12052,Concert,1,172,53.89,55312,40161,26.41,52127,18771,46497,9389,44055.14286,12668.14286,53891,70898,55886,56723.28571
8/10/2023,10,Agency_10,Thursday,36546,10988,Festival,0,172,47.53,55312,40161,29.8,41839,12052,38949,13796,43711.85714,12267,47534,53891,52745,55978.85714
8/11/2023,10,Agency_10,Friday,35985,13825,Sports Event,1,172,49.81,55312,40161,28.1,36546,10988,35887,2454,43725.85714,13891.42857,49810,47534,38341,57617.28571
8/12/2023,10,Agency_10,Saturday,23788,4279,None,0,172,28.07,55312,40161,40.88,35985,13825,55160,14022,39244.14286,12499.57143,28067,49810,69182,51743.71429
8/13/2023,10,Agency_10,Sunday,41265,9300,None,1,172,50.57,55312,40161,28.63,23788,4279,42366,14482,39086.85714,11759.28571,50565,28067,56848,50846.14286
8/14/2023,10,Agency_10,Monday,30243,1749,None,0,172,31.99,55312,40161,39.42,41265,9300,42058,13100,37399,10137.71429,31992,50565,55158,47536.71429
8/15/2023,10,Agency_10,Tuesday,25824,8610,Concert,0,172,34.43,55312,40161,36.83,30243,1749,52127,18771,33641.42857,8686.142857,34434,31992,70898,42327.57143
8/16/2023,10,Agency_10,Wednesday,50087,13799,Concert,1,172,63.89,55312,40161,21.07,25824,8610,41839,12052,34819.71429,8935.714286,63886,34434,53891,43755.42857
8/17/2023,10,Agency_10,Thursday,21552,2745,None,0,172,24.3,55312,40161,43.07,50087,13799,36546,10988,32677.71429,7758.142857,24297,63886,47534,40435.85714
8/18/2023,10,Agency_10,Friday,21322,9596,Concert,0,172,30.92,55312,40161,38.39,21552,2745,35985,13825,30583,7154,30918,24297,49810,37737
8/19/2023,10,Agency_10,Saturday,23722,8698,Festival,0,172,32.42,55312,40161,37.82,21322,9596,23788,4279,30573.57143,7785.285714,32420,30918,28067,38358.85714
8/20/2023,10,Agency_10,Sunday,52659,9390,Concert,1,172,62.05,55312,40161,22.87,23722,8698,41265,9300,32201.28571,7798.142857,62049,32420,50565,39999.42857
8/21/2023,10,Agency_10,Monday,36433,10425,None,1,172,46.86,55312,40161,30.25,52659,9390,30243,1749,33085.57143,9037.571429,46858,62049,31992,42123.14286
8/22/2023,10,Agency_10,Tuesday,18213,5329,Sports Event,0,172,23.54,55312,40161,42.93,36433,10425,25824,8610,31998.28571,8568.857143,23542,46858,34434,40567.14286
8/23/2023,10,Agency_10,Wednesday,12856,5837,Sports Event,0,172,18.69,55312,40161,45.25,18213,5329,50087,13799,26679.57143,7431.428571,18693,23542,63886,34111
8/24/2023,10,Agency_10,Thursday,46470,9929,Festival,1,172,56.4,55312,40161,25.58,12856,5837,21552,2745,30239.28571,8457.714286,56399,18693,24297,38697
8/25/2023,10,Agency_10,Friday,43490,4652,Concert,1,172,48.14,55312,40161,30.77,46470,9929,21322,9596,33406.14286,7751.428571,48142,56399,30918,41157.57143
8/26/2023,10,Agency_10,Saturday,37422,7077,None,1,172,44.5,55312,40161,32.1,43490,4652,23722,8698,35363.28571,7519.857143,44499,48142,32420,42883.14286
8/27/2023,10,Agency_10,Sunday,46940,14894,Sports Event,1,172,61.83,55312,40161,21.87,37422,7077,52659,9390,34546.28571,8306.142857,61834,44499,62049,42852.42857
8/28/2023,10,Agency_10,Monday,13642,2693,None,0,172,16.34,55312,40161,47.06,46940,14894,36433,10425,31290.42857,7201.571429,16335,61834,46858,38492
8/29/2023,10,Agency_10,Tuesday,24838,5797,None,0,172,30.64,55312,40161,39.29,13642,2693,18213,5329,32236.85714,7268.428571,30635,16335,23542,39505.28571
8/30/2023,10,Agency_10,Wednesday,37875,9603,Festival,0,172,47.48,55312,40161,30.11,24838,5797,12856,5837,35811,7806.428571,47478,30635,18693,43617.42857
8/31/2023,10,Agency_10,Thursday,40392,3681,Concert,1,172,44.07,55312,40161,33,37875,9603,46470,9929,34942.71429,6913.857143,44073,47478,56399,41856.57143
9/1/2023,10,Agency_10,Friday,18648,4945,None,0,172,23.59,55312,40161,42.98,40392,3681,43490,4652,31393.85714,6955.714286,23593,44073,48142,38349.57143
9/2/2023,10,Agency_10,Saturday,69650,19718,Festival,1,172,89.37,55312,40161,7.14,18648,4945,37422,7077,35997.85714,8761.571429,89368,23593,44499,44759.42857
9/3/2023,10,Agency_10,Sunday,49824,13690,Concert,0,172,63.51,55312,40161,21.27,69650,19718,46940,14894,36409.85714,8589.571429,63514,89368,61834,44999.42857
9/4/2023,10,Agency_10,Monday,24664,8897,Festival,0,172,33.56,55312,40161,37.21,49824,13690,13642,2693,37984.42857,9475.857143,33561,63514,16335,47460.28571
9/5/2023,10,Agency_10,Tuesday,21181,3121,None,0,172,24.3,55312,40161,42.99,24664,8897,24838,5797,37462,9093.571429,24302,33561,30635,46555.57143
9/6/2023,10,Agency_10,Wednesday,35252,10919,Festival,1,172,46.17,55312,40161,30.5,21181,3121,37875,9603,37087.28571,9281.571429,46171,24302,47478,46368.85714
9/7/2023,10,Agency_10,Thursday,36436,1173,None,1,172,37.61,55312,40161,36.73,35252,10919,40392,3681,36522.14286,8923.285714,37609,46171,44073,45445.42857
9/8/2023,10,Agency_10,Friday,50756,7439,Concert,1,172,58.2,55312,40161,25.18,36436,1173,18648,4945,41109,9279.571429,58195,37609,23593,50388.57143
9/9/2023,10,Agency_10,Saturday,30745,22768,Festival,1,172,53.51,55312,40161,24.46,50756,7439,69650,19718,35551.14286,9715.285714,53513,58195,89368,45266.42857
9/10/2023,10,Agency_10,Sunday,42586,16594,Sports Event,0,172,59.18,55312,40161,22.86,30745,22768,49824,13690,34517.14286,10130.14286,59180,53513,63514,44647.28571
9/11/2023,10,Agency_10,Monday,24003,9119,None,0,172,33.12,55312,40161,37.38,42586,16594,24664,8897,34422.71429,10161.85714,33122,59180,33561,44584.57143
9/12/2023,10,Agency_10,Tuesday,34189,7967,Concert,0,172,42.16,55312,40161,33.1,24003,9119,21181,3121,36281,10854.14286,42156,33122,24302,47135.14286
9/13/2023,10,Agency_10,Wednesday,42342,17816,Sports Event,1,172,60.16,55312,40161,22.13,34189,7967,35252,10919,37293.85714,11839.42857,60158,42156,46171,49133.28571
9/14/2023,10,Agency_10,Thursday,20933,5174,None,1,172,26.11,55312,40161,41.68,42342,17816,36436,1173,35079.14286,12411,26107,60158,37609,47490.14286
9/15/2023,10,Agency_10,Friday,23991,1106,None,1,172,25.1,55312,40161,43,20933,5174,50756,7439,31255.57143,11506.28571,25097,26107,58195,42761.85714
9/16/2023,10,Agency_10,Saturday,48414,3796,Sports Event,1,172,52.21,55312,40161,28.9,23991,1106,30745,22768,33779.71429,8796,52210,25097,53513,42575.71429
9/17/2023,10,Agency_10,Sunday,31613,12248,None,1,172,43.86,55312,40161,31.39,48414,3796,42586,16594,32212.14286,8175.142857,43861,52210,59180,40387.28571
9/18/2023,10,Agency_10,Monday,22899,11695,None,1,172,34.6,55312,40161,36.13,31613,12248,24003,9119,32054.42857,8543.142857,34594,43861,33122,40597.57143
9/19/2023,10,Agency_10,Tuesday,19045,12549,Concert,0,172,31.59,55312,40161,37.46,22899,11695,34189,7967,29891,9197.714286,31594,34594,42156,39088.71429
9/20/2023,10,Agency_10,Wednesday,35062,2663,Festival,0,172,37.73,55312,40161,36.37,19045,12549,42342,17816,28851,7033,37725,31594,60158,35884
9/21/2023,10,Agency_10,Thursday,50329,8282,Concert,0,172,58.61,55312,40161,24.81,35062,2663,20933,5174,33050.42857,7477,58611,37725,26107,40527.42857
9/22/2023,10,Agency_10,Friday,30443,5200,Festival,1,172,35.64,55312,40161,36.91,50329,8282,23991,1106,33972.14286,8061.857143,35643,58611,25097,42034
9/23/2023,10,Agency_10,Saturday,34018,10486,Sports Event,0,172,44.5,55312,40161,31.42,30443,5200,48414,3796,31915.57143,9017.571429,44504,35643,52210,40933.14286
9/24/2023,10,Agency_10,Sunday,36923,9732,Concert,0,172,46.66,55312,40161,30.49,34018,10486,31613,12248,32674.14286,8658.142857,46655,44504,43861,41332.28571
9/25/2023,10,Agency_10,Monday,34749,7180,Festival,0,172,41.93,55312,40161,33.37,36923,9732,22899,11695,34367,8013.142857,41929,46655,34594,42380.14286
9/26/2023,10,Agency_10,Tuesday,20133,11188,Concert,1,172,31.32,55312,40161,37.87,34749,7180,19045,12549,34522.42857,7818.714286,31321,41929,31594,42341.14286
9/27/2023,10,Agency_10,Wednesday,12243,9701,Sports Event,0,172,21.94,55312,40161,42.86,20133,11188,35062,2663,31262.57143,8824.142857,21944,31321,37725,40086.71429
9/28/2023,10,Agency_10,Thursday,19633,7456,None,1,172,27.09,55312,40161,40.73,12243,9701,50329,8282,26877.42857,8706.142857,27089,21944,58611,35583.57143
9/29/2023,10,Agency_10,Friday,39855,5273,Festival,0,172,45.13,55312,40161,32.15,19633,7456,30443,5200,28222,8716.571429,45128,27089,35643,36938.57143
9/30/2023,10,Agency_10,Saturday,30367,5372,None,0,172,35.74,55312,40161,36.82,39855,5273,34018,10486,27700.42857,7986,35739,45128,44504,35686.42857
10/1/2023,10,Agency_10,Sunday,67310,13208,Sports Event,1,172,80.52,55312,40161,12.87,30367,5372,36923,9732,32041.42857,8482.571429,80518,35739,46655,40524
10/2/2023,10,Agency_10,Monday,30804,15170,Festival,1,172,45.97,55312,40161,29.75,67310,13208,34749,7180,31477.85714,9624,45974,80518,41929,41101.85714
10/3/2023,10,Agency_10,Tuesday,26731,5638,Festival,0,172,32.37,55312,40161,38.46,30804,15170,20133,11188,32420.42857,8831.142857,32369,45974,31321,41251.57143
10/4/2023,10,Agency_10,Wednesday,26415,8347,Festival,0,172,34.76,55312,40161,36.72,26731,5638,12243,9701,34445,8637.714286,34762,32369,21944,43082.71429
10/5/2023,10,Agency_10,Thursday,40065,1922,Concert,0,172,41.99,55312,40161,34.39,26415,8347,19633,7456,37363.85714,7847.142857,41987,34762,27089,45211
10/6/2023,10,Agency_10,Friday,30172,10623,Festival,0,172,40.8,55312,40161,33.25,40065,1922,39855,5273,35980.57143,8611.428571,40795,41987,45128,44592
10/7/2023,10,Agency_10,Saturday,37740,16837,Sports Event,0,172,54.58,55312,40161,25.11,30172,10623,30367,5372,37033.85714,10249.28571,54577,40795,35739,47283.14286
10/8/2023,10,Agency_10,Sunday,45929,14325,Concert,1,172,60.25,55312,40161,22.78,37740,16837,67310,13208,33979.42857,10408.85714,60254,54577,80518,44388.28571
10/9/2023,10,Agency_10,Monday,34441,8836,Sports Event,0,172,43.28,55312,40161,32.36,45929,14325,30804,15170,34499,9504,43277,60254,45974,44003
10/10/2023,10,Agency_10,Tuesday,35191,14356,Festival,1,172,49.55,55312,40161,28.12,34441,8836,26731,5638,35707.57143,10749.42857,49547,43277,32369,46457
10/11/2023,10,Agency_10,Wednesday,32637,8989,Festival,1,172,41.63,55312,40161,33.16,35191,14356,26415,8347,36596.42857,10841.14286,41626,49547,34762,47437.57143
10/12/2023,10,Agency_10,Thursday,26040,13100,Festival,0,172,39.14,55312,40161,33.58,32637,8989,40065,1922,34592.85714,12438,39140,41626,41987,47030.85714
10/13/2023,10,Agency_10,Friday,7593,13782,Festival,1,172,21.38,55312,40161,42.32,26040,13100,30172,10623,31367.28571,12889.28571,21375,39140,40795,44256.57143
10/14/2023,10,Agency_10,Saturday,47200,5067,Concert,1,172,52.27,55312,40161,28.62,7593,13782,37740,16837,32718.71429,11207.85714,52267,21375,54577,43926.57143
10/15/2023,10,Agency_10,Sunday,38786,13151,Festival,0,172,51.94,55312,40161,27.17,47200,5067,45929,14325,31698.28571,11040.14286,51937,52267,60254,42738.42857
10/16/2023,10,Agency_10,Monday,34422,0,Concert,0,172,34.42,55312,40161,38.56,38786,13151,34441,8836,31695.57143,9777.857143,34422,51937,43277,41473.42857
10/17/2023,10,Agency_10,Tuesday,40246,5990,Sports Event,0,172,46.24,55312,40161,31.45,34422,0,35191,14356,32417.71429,8582.714286,46236,34422,49547,41000.42857
10/18/2023,10,Agency_10,Wednesday,23432,6482,None,0,172,29.91,55312,40161,39.52,40246,5990,32637,8989,31102.71429,8224.571429,29914,46236,41626,39327.28571
10/19/2023,10,Agency_10,Thursday,30451,15041,Sports Event,1,172,45.49,55312,40161,30.01,23432,6482,26040,13100,31732.85714,8501.857143,45492,29914,39140,40234.71429
10/20/2023,10,Agency_10,Friday,27108,1456,Sports Event,0,172,28.56,55312,40161,41.19,30451,15041,7593,13782,34520.71429,6741,28564,45492,21375,41261.71429
10/21/2023,10,Agency_10,Saturday,31005,4483,None,0,172,35.49,55312,40161,37.13,27108,1456,47200,5067,32207.14286,6657.571429,35488,28564,52267,38864.71429
10/22/2023,10,Agency_10,Sunday,28308,9266,Sports Event,0,172,37.58,55312,40161,35.13,31005,4483,38786,13151,30710.28571,6102.571429,37574,35488,51937,36812.85714
10/23/2023,10,Agency_10,Monday,41653,11626,Festival,1,172,53.28,55312,40161,26.8,28308,9266,34422,0,31743.28571,7763.428571,53279,37574,34422,39506.71429
10/24/2023,10,Agency_10,Tuesday,44343,5523,Festival,1,172,49.87,55312,40161,29.73,41653,11626,40246,5990,32328.57143,7696.714286,49866,53279,46236,40025.28571
10/25/2023,10,Agency_10,Wednesday,24432,8105,Concert,0,172,32.54,55312,40161,37.88,44343,5523,23432,6482,32471.42857,7928.571429,32537,49866,29914,40400
10/26/2023,10,Agency_10,Thursday,38335,6680,None,1,172,45.02,55312,40161,31.92,24432,8105,30451,15041,33597.71429,6734.142857,45015,32537,45492,40331.85714
10/27/2023,10,Agency_10,Friday,38139,8630,Festival,0,172,46.77,55312,40161,30.66,38335,6680,27108,1456,35173.57143,7759,46769,45015,28564,42932.57143
10/28/2023,10,Agency_10,Saturday,31645,9958,Sports Event,0,172,41.6,55312,40161,32.98,38139,8630,31005,4483,35265,8541.142857,41603,46769,35488,43806.14286
10/29/2023,10,Agency_10,Sunday,34482,13717,Concert,0,172,48.2,55312,40161,28.93,31645,9958,28308,9266,36147,9177,48199,41603,37574,45324
10/30/2023,10,Agency_10,Monday,52402,13611,Festival,1,172,66.01,55312,40161,20.04,34482,13717,41653,11626,37682.57143,9460.571429,66013,48199,53279,47143.14286
10/31/2023,10,Agency_10,Tuesday,38902,5219,Concert,0,172,44.12,55312,40161,32.66,52402,13611,44343,5523,36905.28571,9417.142857,44121,66013,49866,46322.42857
11/1/2023,10,Agency_10,Wednesday,26889,6036,Festival,0,172,32.93,55312,40161,38.1,38902,5219,24432,8105,37256.28571,9121.571429,32925,44121,32537,46377.85714
11/2/2023,10,Agency_10,Thursday,42065,10191,Concert,1,172,52.26,55312,40161,27.6,26889,6036,38335,6680,37789.14286,9623.142857,52256,32925,45015,47412.28571
11/3/2023,10,Agency_10,Friday,35472,5332,Festival,0,172,40.8,55312,40161,34.3,42065,10191,38139,8630,37408.14286,9152,40804,52256,46769,46560.14286
11/4/2023,10,Agency_10,Saturday,47303,19718,Festival,1,172,67.02,55312,40161,18.31,35472,5332,31645,9958,39645,10546.28571,67021,40804,41603,50191.28571
11/5/2023,10,Agency_10,Sunday,17411,20427,Concert,0,172,37.84,55312,40161,32.76,47303,19718,34482,13717,37206.28571,11504.85714,37838,67021,48199,48711.14286
11/6/2023,10,Agency_10,Monday,36238,2258,Concert,1,172,38.5,55312,40161,36.07,17411,20427,52402,13611,34897.14286,9883,38496,37838,66013,44780.14286
11/7/2023,10,Agency_10,Tuesday,27027,7092,None,1,172,34.12,55312,40161,37.29,36238,2258,38902,5219,33200.71429,10150.57143,34119,38496,44121,43351.28571
11/8/2023,10,Agency_10,Wednesday,29385,11869,Sports Event,0,172,41.25,55312,40161,32.77,27027,7092,26889,6036,33557.28571,10983.85714,41254,34119,32925,44541.14286
11/9/2023,10,Agency_10,Thursday,35605,9511,Concert,0,172,45.12,55312,40161,31.31,29385,11869,42065,10191,32634.42857,10886.71429,45116,41254,52256,43521.14286
11/10/2023,10,Agency_10,Friday,22250,4791,None,0,172,27.04,55312,40161,41.29,35605,9511,35472,5332,30745.57143,10809.42857,27041,45116,40804,41555
11/11/2023,10,Agency_10,Saturday,34652,2653,None,0,172,37.31,55312,40161,36.59,22250,4791,47303,19718,28938.28571,8371.571429,37305,27041,67021,37309.85714
11/12/2023,10,Agency_10,Sunday,37256,11337,Festival,0,172,48.59,55312,40161,29.2,34652,2653,17411,20427,31773.28571,7073,48593,37305,37838,38846.28571
11/13/2023,10,Agency_10,Monday,36099,5630,Festival,0,172,41.73,55312,40161,33.78,37256,11337,36238,2258,31753.42857,7554.714286,41729,48593,38496,39308.14286
11/14/2023,10,Agency_10,Tuesday,14665,7438,None,1,172,22.1,55312,40161,43.23,36099,5630,27027,7092,29987.42857,7604.142857,22103,41729,34119,37591.57143
11/15/2023,10,Agency_10,Wednesday,32109,13564,Sports Event,0,172,45.67,55312,40161,30.22,14665,7438,29385,11869,30376.57143,7846.285714,45673,22103,41254,38222.85714
11/16/2023,10,Agency_10,Thursday,20472,12425,Sports Event,0,172,32.9,55312,40161,36.83,32109,13564,35605,9511,28214.71429,8262.571429,32897,45673,45116,36477.28571
11/17/2023,10,Agency_10,Friday,62082,10100,Festival,1,172,72.18,55312,40161,17.66,20472,12425,22250,4791,33905,9021,72182,32897,27041,42926
11/18/2023,10,Agency_10,Saturday,31695,12951,Sports Event,1,172,44.65,55312,40161,30.86,62082,10100,34652,2653,33482.57143,10492.14286,44646,72182,37305,43974.71429
11/19/2023,10,Agency_10,Sunday,31309,11151,None,1,172,42.46,55312,40161,32.31,31695,12951,37256,11337,32633,10465.57143,42460,44646,48593,43098.57143
11/20/2023,10,Agency_10,Monday,33233,19301,Sports Event,1,172,52.54,55312,40161,25.64,31309,11151,36099,5630,32223.57143,12418.57143,52534,42460,41729,44642.14286
11/21/2023,10,Agency_10,Tuesday,14427,1521,None,0,172,15.95,55312,40161,47.49,33233,19301,14665,7438,32189.57143,11573.28571,15948,52534,22103,43762.85714
11/22/2023,10,Agency_10,Wednesday,33192,630,None,1,172,33.82,55312,40161,38.73,14427,1521,32109,13564,32344.28571,9725.571429,33822,15948,45673,42069.85714
11/23/2023,10,Agency_10,Thursday,37009,26739,Sports Event,1,172,63.75,55312,40161,18.55,33192,630,20472,12425,34706.71429,11770.42857,63748,33822,32897,46477.14286
11/24/2023,10,Agency_10,Friday,29908,4688,Festival,0,172,34.6,55312,40161,37.53,37009,26739,62082,10100,30110.42857,10997.28571,34596,63748,72182,41107.71429
11/25/2023,10,Agency_10,Saturday,35483,10824,Sports Event,0,172,46.31,55312,40161,30.45,29908,4688,31695,12951,30651.57143,10693.42857,46307,34596,44646,41345
11/26/2023,10,Agency_10,Sunday,37445,13976,Festival,0,172,51.42,55312,40161,27.26,35483,10824,31309,11151,31528.14286,11097,51421,46307,42460,42625.14286
11/27/2023,10,Agency_10,Monday,14804,8375,None,0,172,23.18,55312,40161,42.5,37445,13976,33233,19301,28895.42857,9536.142857,23179,51421,52534,38431.57143
11/28/2023,10,Agency_10,Tuesday,31837,10970,Sports Event,0,172,42.81,55312,40161,32.17,14804,8375,14427,1521,31382.57143,10886,42807,23179,15948,42268.57143
11/29/2023,10,Agency_10,Wednesday,25288,12872,Concert,0,172,38.16,55312,40161,34.11,31837,10970,33192,630,30253.42857,12634.85714,38160,42807,33822,42888.28571
11/30/2023,10,Agency_10,Thursday,36492,13220,Concert,1,172,49.71,55312,40161,28.27,25288,12872,37009,26739,30179.57143,10703.57143,49712,38160,63748,40883.14286
12/1/2023,10,Agency_10,Friday,23001,5110,Festival,0,172,28.11,55312,40161,40.69,36492,13220,29908,4688,29192.85714,10763.85714,28111,49712,34596,39956.71429
12/2/2023,10,Agency_10,Saturday,28129,5345,None,0,172,33.47,55312,40161,37.96,23001,5110,35483,10824,28142.28571,9981.142857,33474,28111,46307,38123.42857
12/3/2023,10,Agency_10,Sunday,36808,11488,Sports Event,1,172,48.3,55312,40161,29.32,28129,5345,37445,13976,28051.28571,9625.714286,48296,33474,51421,37677
12/4/2023,10,Agency_10,Monday,30542,5237,None,1,172,35.78,55312,40161,36.83,36808,11488,14804,8375,30299.57143,9177.428571,35779,48296,23179,39477
12/5/2023,10,Agency_10,Tuesday,29116,8551,Festival,0,172,37.67,55312,40161,35.22,30542,5237,31837,10970,29910.85714,8831.857143,37667,35779,42807,38742.71429
12/6/2023,10,Agency_10,Wednesday,13536,2879,None,1,172,16.42,55312,40161,46.98,29116,8551,25288,12872,28232,7404.285714,16415,37667,38160,35636.28571
12/7/2023,10,Agency_10,Thursday,42277,8389,Concert,1,172,50.67,55312,40161,28.76,13536,2879,36492,13220,29058.42857,6714.142857,50666,16415,49712,35772.57143
12/8/2023,10,Agency_10,Friday,32867,9706,None,1,172,42.57,55312,40161,32.54,42277,8389,23001,5110,30467.85714,7370.714286,42573,50666,28111,37838.57143
12/9/2023,10,Agency_10,Saturday,42471,19092,Concert,0,172,61.56,55312,40161,21.17,32867,9706,28129,5345,32516.71429,9334.571429,61563,42573,33474,41851.28571
12/10/2023,10,Agency_10,Sunday,35251,13916,Sports Event,0,172,49.17,55312,40161,28.4,42471,19092,36808,11488,32294.28571,9681.428571,49167,61563,48296,41975.71429
12/11/2023,10,Agency_10,Monday,25615,16836,Sports Event,0,172,42.45,55312,40161,31.18,35251,13916,30542,5237,31590.42857,11338.42857,42451,49167,35779,42928.85714
12/12/2023,10,Agency_10,Tuesday,29918,5023,None,0,172,34.94,55312,40161,37.29,25615,16836,29116,8551,31705,10834.42857,34941,42451,37667,42539.42857
12/13/2023,10,Agency_10,Wednesday,28511,10805,None,1,172,39.32,55312,40161,33.95,29918,5023,13536,2879,33844.28571,11966.71429,39316,34941,16415,45811
12/14/2023,10,Agency_10,Thursday,28896,6266,Festival,0,172,35.16,55312,40161,36.93,28511,10805,42277,8389,31932.71429,11663.42857,35162,39316,50666,43596.14286
12/15/2023,10,Agency_10,Friday,36553,8765,Concert,0,172,45.32,55312,40161,31.36,28896,6266,32867,9706,32459.28571,11529,45318,35162,42573,43988.28571
12/16/2023,10,Agency_10,Saturday,37645,7361,Sports Event,0,172,45.01,55312,40161,31.79,36553,8765,42471,19092,31769.85714,9853.142857,45006,45318,61563,41623
12/17/2023,10,Agency_10,Sunday,26701,16930,Festival,1,172,43.63,55312,40161,30.57,37645,7361,35251,13916,30548.42857,10283.71429,43631,45006,49167,40832.14286
12/18/2023,10,Agency_10,Monday,24524,4548,None,0,172,29.07,55312,40161,40.32,26701,16930,25615,16836,30392.57143,8528.285714,29072,43631,42451,38920.85714
12/19/2023,10,Agency_10,Tuesday,27182,3592,None,0,172,30.77,55312,40161,39.66,24524,4548,29918,5023,30001.71429,8323.857143,30774,29072,34941,38325.57143
12/20/2023,10,Agency_10,Wednesday,28715,11578,Festival,1,172,40.29,55312,40161,33.31,27182,3592,28511,10805,30030.85714,8434.285714,40293,30774,39316,38465.14286
12/21/2023,10,Agency_10,Thursday,29380,11116,Sports Event,0,172,40.5,55312,40161,33.3,28715,11578,28896,6266,30100,9127.142857,40496,40293,35162,39227.14286
12/22/2023,10,Agency_10,Friday,24187,13151,Sports Event,0,172,37.34,55312,40161,34.47,29380,11116,36553,8765,28333.42857,9753.714286,37338,40496,45318,38087.14286
12/23/2023,10,Agency_10,Saturday,46541,8956,None,1,172,55.5,55312,40161,26.23,24187,13151,37645,7361,29604.28571,9981.571429,55497,37338,45006,39585.85714
12/24/2023,10,Agency_10,Sunday,61420,8932,Sports Event,1,172,70.35,55312,40161,18.81,46541,8956,26701,16930,34564.14286,8839,70352,55497,43631,43403.14286
12/25/2023,10,Agency_10,Monday,38064,12059,Sports Event,0,172,50.12,55312,40161,28.29,61420,8932,24524,4548,36498.42857,9912,50123,70352,29072,46410.42857
12/26/2023,10,Agency_10,Tuesday,36475,8445,Festival,0,172,44.92,55312,40161,31.62,38064,12059,27182,3592,37826,10605.28571,44920,50123,30774,48431.28571
12/27/2023,10,Agency_10,Wednesday,10194,8844,Sports Event,1,172,19.04,55312,40161,44.48,36475,8445,28715,11578,35180.14286,10214.71429,19038,44920,40293,45394.85714
12/28/2023,10,Agency_10,Thursday,25305,5173,Concert,0,172,30.48,55312,40161,39.5,10194,8844,29380,11116,34598,9365.714286,30478,19038,40496,43963.71429
12/29/2023,10,Agency_10,Friday,20611,4162,None,0,172,24.77,55312,40161,42.55,25305,5173,24187,13151,34087.14286,8081.571429,24773,30478,37338,42168.71429
12/30/2023,10,Agency_10,Saturday,19051,3746,None,0,172,22.8,55312,40161,43.62,20611,4162,46541,8956,30160,7337.285714,22797,24773,55497,37497.28571
12/31/2023,10,Agency_10,Sunday,38427,22406,Concert,1,172,60.83,55312,40161,20.87,19051,3746,61420,8932,26875.28571,9262.142857,60833,22797,70352,36137.42857
